aah	ah
aahed	ahed
aahing	ahing
aahs	ahs
aal	al
aals	als
aas	as
aba	ba
aback	back
abacterial	bacterial
abas	bas
abase	base
abased	based
abasement	basement
abasements	basements
abaser	baser
abases	bases
abash	bash
abashed	bashed
abashes	bashes
abashing	bashing
abasing	basing
abate	bate
abated	bated
abates	bates
abating	bating
abeam	beam
abed	bed
abet	bet
abets	bets
abetted	betted
abetter	better
abetters	betters
abetting	betting
abettor	bettor
abettors	bettors
abide	bide
abided	bided
abider	bider
abiders	biders
abides	bides
abiding	biding
abiogeneses	biogeneses
abiogenesis	biogenesis
abiogenic	biogenic
abiological	biological
abiotic	biotic
ablate	blate
ablaze	blaze
abled	bled
ablest	blest
abloom	bloom
ablush	blush
abo	bo
aboard	board
abode	bode
aboded	boded
abodes	bodes
aboding	boding
aboil	boil
aboon	boon
aboral	boral
abort	bort
aborts	borts
abos	bos
abought	bought
abound	bound
abounded	bounded
abounding	bounding
abounds	bounds
about	bout
abrachia	brachia
abraid	braid
abraided	braided
abraider	braider
abraiders	braiders
abraiding	braiding
abraids	braids
abreast	breast
abridge	bridge
abridged	bridged
abridges	bridges
abridging	bridging
abris	bris
abroach	broach
abroad	broad
abubble	bubble
abuilding	building
abused	bused
abuses	buses
abusing	busing
abut	but
abuts	buts
abuttals	buttals
abutted	butted
abutter	butter
abutters	butters
abutting	butting
abuzz	buzz
aby	by
abye	bye
abyes	byes
abys	bys
acanthi	canthi
acanthus	canthus
acatalectic	catalectic
acatalectics	catalectics
acaudal	caudal
acaudate	caudate
acauline	cauline
acellular	cellular
acentric	centric
acerate	cerate
acerated	cerated
acerous	cerous
achondrite	chondrite
achondrites	chondrites
achondritic	chondritic
achromatic	chromatic
achromatically	chromatically
achromic	chromic
aclinic	clinic
acock	cock
acoelomate	coelomate
acoelomates	coelomates
acold	cold
acorn	corn
acorns	corns
acred	cred
across	cross
acute	cute
acutely	cutely
acuteness	cuteness
acutenesses	cutenesses
acuter	cuter
acutes	cutes
acutest	cutest
acyclic	cyclic
adeem	deem
adeemed	deemed
adeeming	deeming
adeems	deems
adit	dit
adits	dits
ado	do
adore	dore
ados	dos
adown	down
adoze	doze
adrift	drift
adroit	droit
adust	dust
adynamic	dynamic
aedile	edile
aediles	ediles
aegis	egis
aegises	egises
aeolian	eolian
aeon	eon
aeonian	eonian
aeons	eons
aerugo	erugo
aerugos	erugos
aesthete	esthete
aesthetes	esthetes
aesthetic	esthetic
aesthetician	esthetician
aestheticians	estheticians
aestheticism	estheticism
aestheticisms	estheticisms
aesthetics	esthetics
aestival	estival
aestivate	estivate
aestivated	estivated
aestivates	estivates
aestivating	estivating
aestivation	estivation
aestivations	estivations
aether	ether
aetheric	etheric
aethers	ethers
aetiologies	etiologies
aetiology	etiology
afar	far
afeared	feared
afebrile	febrile
afield	field
afire	fire
aflame	flame
afloat	float
aflutter	flutter
afoam	foam
afoot	foot
afore	fore
aforesaid	foresaid
aforethought	forethought
afoul	foul
afresh	fresh
afrit	frit
afrits	frits
afro	fro
again	gain
against	gainst
agama	gama
agamas	gamas
agamete	gamete
agametes	gametes
agamic	gamic
agape	gape
agar	gar
agars	gars
agas	gas
agate	gate
agates	gates
agave	gave
agaze	gaze
aged	ged
agee	gee
agene	gene
agenes	genes
ageneses	geneses
agenesis	genesis
agenetic	genetic
agent	gent
agentries	gentries
agentry	gentry
agents	gents
aghast	ghast
agin	gin
aginner	ginner
aginners	ginners
agist	gist
agists	gists
aglare	glare
agleam	gleam
aglee	glee
agley	gley
aglimmer	glimmer
aglitter	glitter
aglow	glow
agnostic	gnostic
agnosticism	gnosticism
agnosticisms	gnosticisms
ago	go
agone	gone
agouty	gouty
agranulocyte	granulocyte
agranulocytes	granulocytes
agraphic	graphic
agree	gree
agreed	greed
agreeing	greeing
agrees	grees
aground	ground
aha	ha
ahead	head
ahem	hem
ahi	hi
ahistoric	historic
ahistorical	historical
ahold	hold
aholds	holds
ahorse	horse
ahoy	hoy
ahull	hull
aid	id
aides	ides
aids	ids
ain	in
ains	ins
aired	ired
airing	iring
ais	is
aisle	isle
aisled	isled
aisles	isles
ait	it
aitch	itch
aitches	itches
aits	its
ajar	jar
ajee	jee
ajuga	juga
akin	kin
ala	la
alack	lack
aland	land
alands	lands
alane	lane
alang	lang
alar	lar
alarum	larum
alarums	larums
alas	las
alate	late
alated	lated
alee	lee
alevin	levin
alevins	levins
alien	lien
alienable	lienable
aliens	liens
alight	light
alighted	lighted
alighting	lighting
alights	lights
alike	like
alikeness	likeness
alikenesses	likenesses
aline	line
alined	lined
aliner	liner
aliners	liners
alines	lines
alining	lining
alist	list
alit	lit
aliteracies	literacies
aliteracy	literacy
aliterate	literate
aliterates	literates
alive	live
aliveness	liveness
alivenesses	livenesses
aloft	loft
alogical	logical
alogically	logically
aloin	loin
aloins	loins
alone	lone
aloneness	loneness
alonenesses	lonenesses
along	long
aloof	loof
aloud	loud
alow	low
alum	lum
alumina	lumina
aluminous	luminous
alums	lums
alure	lure
ama	ma
amain	main
amas	mas
amass	mass
amassed	massed
amasses	masses
amassing	massing
amaze	maze
amazed	mazed
amazedly	mazedly
amazes	mazes
amazing	mazing
ameliorate	meliorate
ameliorated	meliorated
ameliorates	meliorates
ameliorating	meliorating
amelioration	melioration
ameliorations	meliorations
ameliorative	meliorative
ameliorator	meliorator
ameliorators	meliorators
amen	men
amend	mend
amendable	mendable
amended	mended
amender	mender
amenders	menders
amending	mending
amends	mends
amercer	mercer
amercers	mercers
ami	mi
amice	mice
amid	mid
amids	mids
amidship	midship
amidships	midships
amidst	midst
amine	mine
amines	mines
amir	mir
amirs	mirs
amis	mis
amiss	miss
amitoses	mitoses
amitosis	mitosis
amitotic	mitotic
amitotically	mitotically
amity	mity
amole	mole
amoles	moles
amongst	mongst
amoral	moral
amoralism	moralism
amoralisms	moralisms
amoralities	moralities
amorality	morality
amorally	morally
amort	mort
amortise	mortise
amortised	mortised
amortises	mortises
amortising	mortising
amotion	motion
amotions	motions
amount	mount
amounted	mounted
amounting	mounting
amounts	mounts
amu	mu
amuck	muck
amucks	mucks
amus	mus
amuse	muse
amused	mused
amuser	muser
amusers	musers
amuses	muses
amusing	musing
amusingly	musingly
amyotonia	myotonia
amyotonias	myotonias
ana	na
ane	ne
anear	near
aneared	neared
anearing	nearing
anears	nears
anew	new
anil	nil
anils	nils
anodal	nodal
anodally	nodally
anode	node
anodes	nodes
another	nother
anus	nus
apace	pace
apart	part
apathetic	pathetic
apathetically	pathetically
ape	pe
apeak	peak
aped	ped
apeek	peek
aper	per
aperiodic	periodic
aperiodically	periodically
aperiodicities	periodicities
aperiodicity	periodicity
apes	pes
apetalous	petalous
aphasic	phasic
aphis	phis
aphonic	phonic
aphonics	phonics
aphotic	photic
apian	pian
apical	pical
apiece	piece
aping	ping
apish	pish
aplastic	plastic
aplenty	plenty
apod	pod
apods	pods
apolitical	political
apolitically	politically
aport	port
apractic	practic
apriorities	priorities
apriority	priority
apsis	psis
apyretic	pyretic
aqua	qua
aquiver	quiver
arabic	rabic
are	re
areal	real
areally	really
ares	res
arete	rete
aria	ria
arias	rias
arid	rid
arider	rider
ariel	riel
ariels	riels
aright	right
ariled	riled
arise	rise
arisen	risen
arises	rises
arising	rising
arose	rose
around	round
arouse	rouse
aroused	roused
arouser	rouser
arousers	rousers
arouses	rouses
arousing	rousing
arugola	rugola
arugolas	rugolas
arum	rum
arums	rums
ascend	scend
ascended	scended
ascending	scending
ascends	scends
ascent	scent
ascents	scents
ascot	scot
ascots	scots
ascribe	scribe
ascribed	scribed
ascribes	scribes
ascribing	scribing
asea	sea
asepses	sepses
asepsis	sepsis
aseptic	septic
asexual	sexual
asexualities	sexualities
asexuality	sexuality
asexually	sexually
ash	sh
ashamed	shamed
ashed	shed
ashes	shes
ashier	shier
ashiest	shiest
ashore	shore
ashy	shy
aside	side
asides	sides
askew	skew
askewness	skewness
askewnesses	skewnesses
aslant	slant
asleep	sleep
aslope	slope
asocial	social
asparkle	sparkle
aspheric	spheric
aspherical	spherical
aspirant	spirant
aspirants	spirants
aspire	spire
aspired	spired
aspires	spires
aspiring	spiring
asquint	squint
astarboard	starboard
astatic	static
astern	stern
asternal	sternal
asteroid	steroid
asteroidal	steroidal
asteroids	steroids
asthenia	sthenia
asthenias	sthenias
asthenic	sthenic
astigmatic	stigmatic
astigmatics	stigmatics
astir	stir
astonish	stonish
astonished	stonished
astonishes	stonishes
astonishing	stonishing
astony	stony
astound	stound
astounded	stounded
astounding	stounding
astounds	stounds
astraddle	straddle
astray	stray
astrict	strict
astride	stride
astringed	stringed
astringencies	stringencies
astringency	stringency
astringent	stringent
astringently	stringently
astringing	stringing
astylar	stylar
asunder	sunder
aswarm	swarm
aswirl	swirl
aswoon	swoon
asymmetric	symmetric
asymmetrical	symmetrical
asymmetrically	symmetrically
asymmetries	symmetries
asymmetry	symmetry
asymptomatic	symptomatic
asymptomatically	symptomatically
asynapses	synapses
asynapsis	synapsis
asynchronies	synchronies
asynchronism	synchronism
asynchronisms	synchronisms
asynchronous	synchronous
asynchronously	synchronously
asynchrony	synchrony
asyndetic	syndetic
asyndetically	syndetically
atactic	tactic
atap	tap
ataps	taps
ataxies	taxies
atechnic	technic
atelic	telic
atemporal	temporal
atheism	theism
atheisms	theisms
atheist	theist
atheistic	theistic
atheistical	theistical
atheistically	theistically
atheists	theists
atheoretical	theoretical
athirst	thirst
athwart	thwart
atilt	tilt
atingle	tingle
atoll	toll
atolls	tolls
atom	tom
atoms	toms
atonal	tonal
atonalities	tonalities
atonality	tonality
atonally	tonally
atone	tone
atoned	toned
atoner	toner
atoners	toners
atones	tones
atonic	tonic
atonics	tonics
atoning	toning
atony	tony
atop	top
atopic	topic
atremble	tremble
atrial	trial
atrip	trip
atrophic	trophic
atrophied	trophied
atrophies	trophies
atrophy	trophy
atrophying	trophying
atropin	tropin
atropine	tropine
atropines	tropines
atropins	tropins
atropism	tropism
atropisms	tropisms
atwain	twain
atween	tween
atwitter	twitter
atypic	typic
atypical	typical
atypicalities	typicalities
atypicality	typicality
atypically	typically
auntie	untie
aunties	unties
aurate	urate
auric	uric
avail	vail
availed	vailed
availing	vailing
avails	vails
avarices	varices
avascular	vascular
avascularities	vascularities
avascularity	vascularity
avast	vast
avaunt	vaunt
avenge	venge
avenged	venged
avenges	venges
avenging	venging
aventail	ventail
aventails	ventails
avenue	venue
avenues	venues
averse	verse
aversion	version
aversions	versions
avert	vert
averts	verts
aviator	viator
aviators	viators
avid	vid
avirulent	virulent
avocation	vocation
avocational	vocational
avocationally	vocationally
avocations	vocations
avoid	void
avoidable	voidable
avoidance	voidance
avoidances	voidances
avoided	voided
avoider	voider
avoiders	voiders
avoiding	voiding
avoids	voids
avouch	vouch
avouched	vouched
avoucher	voucher
avouchers	vouchers
avouches	vouches
avouching	vouching
avow	vow
avowed	vowed
avower	vower
avowers	vowers
avowing	vowing
avows	vows
await	wait
awaited	waited
awaiter	waiter
awaiters	waiters
awaiting	waiting
awaits	waits
awake	wake
awaked	waked
awaken	waken
awakened	wakened
awakener	wakener
awakeners	wakeners
awakening	wakening
awakens	wakens
awakes	wakes
awaking	waking
award	ward
awarded	warded
awarder	warder
awarders	warders
awarding	warding
awards	wards
aware	ware
awash	wash
away	way
awe	we
aweary	weary
aweather	weather
awed	wed
awee	wee
aweigh	weigh
awhile	while
awhirl	whirl
awing	wing
awoke	woke
awoken	woken
awry	wry
axenic	xenic
axis	xis
ayah	yah
aye	ye
ayes	yes
ayin	yin
ayins	yins
azine	zine
azines	zines
azoic	zoic
azonal	zonal
azygoses	zygoses
baa	aa
baal	aal
baals	aals
baas	aas
baba	aba
babas	abas
baboon	aboon
baby	aby
babying	abying
bached	ached
baches	aches
baching	aching
bad	ad
badder	adder
badman	adman
badmen	admen
bads	ads
baff	aff
bag	ag
bagger	agger
baggers	aggers
baggie	aggie
baggies	aggies
bah	ah
bail	ail
bailed	ailed
bailing	ailing
bailment	ailment
bailments	ailments
bails	ails
bairn	airn
bairns	airns
bait	ait
baits	aits
bal	al
balas	alas
balder	alder
bale	ale
bales	ales
balky	alky
ball	all
ballies	allies
ballot	allot
ballots	allots
balls	alls
bally	ally
balms	alms
bals	als
bam	am
ban	an
banal	anal
banalities	analities
banality	anality
banally	anally
band	and
bands	ands
bane	ane
banes	anes
banger	anger
bangers	angers
bangle	angle
bangles	angles
bani	ani
bar	ar
barb	arb
barbs	arbs
bare	are
bares	ares
barf	arf
barfs	arfs
barista	arista
baristas	aristas
bark	ark
barks	arks
barm	arm
barms	arms
barmy	army
barrack	arrack
barracks	arracks
barrow	arrow
barrows	arrows
bars	ars
bartisan	artisan
bartisans	artisans
bas	as
bash	ash
bashed	ashed
bashes	ashes
bashing	ashing
bask	ask
basked	asked
basking	asking
basks	asks
bass	ass
basses	asses
basset	asset
bassets	assets
bassist	assist
bassists	assists
baster	aster
basters	asters
bat	at
bate	ate
bates	ates
batman	atman
batt	att
bawl	awl
bawls	awls
bay	ay
bays	ays
beach	each
beagle	eagle
beagles	eagles
bear	ear
bearing	earing
bearings	earings
bears	ears
beast	east
beastings	eastings
beasts	easts
beat	eat
beatable	eatable
beaten	eaten
beater	eater
beaters	eaters
beating	eating
beatings	eatings
beats	eats
beau	eau
beaux	eaux
bed	ed
beerier	eerier
beeriest	eeriest
beery	eery
beggar	eggar
beggars	eggars
begged	egged
begging	egging
bel	el
belated	elated
belatedly	elatedly
belatedness	elatedness
belatednesses	elatednesses
bell	ell
bells	ells
bels	els
ben	en
bend	end
bended	ended
bender	ender
benders	enders
bending	ending
bends	ends
bendways	endways
bendwise	endwise
bens	ens
berg	erg
bergs	ergs
bespouse	espouse
bespoused	espoused
bespouses	espouses
bespousing	espousing
bet	et
beta	eta
betas	etas
beth	eth
beths	eths
bhang	hang
bhangs	hangs
bhoot	hoot
bhoots	hoots
bhut	hut
bhuts	huts
bice	ice
bices	ices
bicker	icker
bickers	ickers
bid	id
bides	ides
bids	ids
biff	iff
biffy	iffy
bigging	igging
bilk	ilk
bilks	ilks
bill	ill
biller	iller
bills	ills
billy	illy
bin	in
binned	inned
binning	inning
bins	ins
bionic	ionic
bionics	ionics
biota	iota
biotas	iotas
birk	irk
birks	irks
bis	is
bit	it
bitch	itch
bitches	itches
biter	iter
bits	its
blab	lab
blabs	labs
black	lack
blacked	lacked
blacker	lacker
blacking	lacking
blacks	lacks
bladder	ladder
bladderlike	ladderlike
bladders	ladders
blade	lade
bladed	laded
blades	lades
blain	lain
blam	lam
blame	lame
blamed	lamed
blamer	lamer
blames	lames
blaming	laming
blams	lams
bland	land
blander	lander
blank	lank
blanker	lanker
blankest	lankest
blankly	lankly
blankness	lankness
blanknesses	lanknesses
blares	lares
blase	lase
blast	last
blasted	lasted
blaster	laster
blasters	lasters
blasting	lasting
blastings	lastings
blasts	lasts
blat	lat
blate	late
blather	lather
blathered	lathered
blatherer	latherer
blatherers	latherers
blathering	lathering
blathers	lathers
blats	lats
blatter	latter
blaw	law
blawed	lawed
blawing	lawing
blawn	lawn
blaws	laws
blaze	laze
blazed	lazed
blazes	lazes
blazing	lazing
bleach	leach
bleachable	leachable
bleached	leached
bleacher	leacher
bleachers	leachers
bleaches	leaches
bleaching	leaching
bleak	leak
bleaker	leaker
bleaks	leaks
blear	lear
blearier	learier
bleariest	leariest
blears	lears
bleary	leary
bled	led
blend	lend
blender	lender
blenders	lenders
blending	lending
blends	lends
blent	lent
bless	less
blesser	lesser
blest	lest
blet	let
blets	lets
blight	light
blighted	lighted
blighter	lighter
blighters	lighters
blighting	lighting
blights	lights
blimey	limey
blimp	limp
blimps	limps
blimy	limy
blin	lin
bling	ling
blink	link
blinked	linked
blinker	linker
blinkers	linkers
blinking	linking
blinks	links
blip	lip
blipped	lipped
blipping	lipping
blips	lips
blister	lister
blisters	listers
blite	lite
blithe	lithe
blithely	lithely
blither	lither
blithesome	lithesome
blithest	lithest
blob	lob
blobbed	lobbed
blobbing	lobbing
blobs	lobs
block	lock
blockage	lockage
blockages	lockages
blocked	locked
blocker	locker
blockers	lockers
blocking	locking
blocks	locks
blog	log
blogger	logger
bloggers	loggers
blogs	logs
blooey	looey
blooie	looie
bloom	loom
bloomed	loomed
blooming	looming
blooms	looms
bloop	loop
blooped	looped
blooper	looper
bloopers	loopers
blooping	looping
bloops	loops
blot	lot
blots	lots
blotted	lotted
blotting	lotting
blotto	lotto
blouse	louse
bloused	loused
blouses	louses
blousier	lousier
blousiest	lousiest
blousily	lousily
blousing	lousing
blousy	lousy
blow	low
blowball	lowball
blowballs	lowballs
blowdown	lowdown
blowdowns	lowdowns
blowed	lowed
blower	lower
blowers	lowers
blowing	lowing
blown	lown
blows	lows
blubber	lubber
blubbers	lubbers
blues	lues
bluff	luff
bluffed	luffed
bluffing	luffing
bluffs	luffs
blunge	lunge
blunged	lunged
blunger	lunger
blungers	lungers
blunges	lunges
blunging	lunging
blunt	lunt
blunted	lunted
blunting	lunting
blunts	lunts
blush	lush
blushed	lushed
blusher	lusher
blushes	lushes
blushing	lushing
bluster	luster
blustered	lustered
blustering	lustering
blusters	lusters
boar	oar
boarfish	oarfish
boarfishes	oarfishes
boars	oars
boast	oast
boasts	oasts
boat	oat
boater	oater
boaters	oaters
boatlike	oatlike
boats	oats
bod	od
bode	ode
bodes	odes
bods	ods
boff	off
boffs	offs
bogle	ogle
bogles	ogles
boil	oil
boiled	oiled
boiler	oiler
boilers	oilers
boiling	oiling
boils	oils
bokeh	okeh
bold	old
bolder	older
boldest	oldest
boldness	oldness
boldnesses	oldnesses
bolds	olds
bole	ole
boles	oles
bomber	omber
bombers	ombers
bone	one
bones	ones
bonus	onus
bonuses	onuses
boodles	oodles
boot	oot
boots	oots
booze	ooze
boozed	oozed
boozes	oozes
boozier	oozier
booziest	ooziest
boozily	oozily
boozing	oozing
boozy	oozy
bop	op
bops	ops
bora	ora
boral	oral
borals	orals
borate	orate
borated	orated
borates	orates
borating	orating
border	order
bordered	ordered
borderer	orderer
borderers	orderers
bordering	ordering
borders	orders
bordure	ordure
bordures	ordures
bore	ore
bores	ores
bort	ort
borts	orts
bos	os
bother	other
bothers	others
bought	ought
bounce	ounce
bounces	ounces
bout	out
bouts	outs
bovine	ovine
bovines	ovines
bow	ow
bowed	owed
bowing	owing
bowl	owl
bowllike	owllike
bowls	owls
bowse	owse
box	ox
boxes	oxes
boxy	oxy
boy	oy
brabble	rabble
brabbled	rabbled
brabbler	rabbler
brabblers	rabblers
brabbles	rabbles
brabbling	rabbling
brace	race
braced	raced
bracer	racer
bracers	racers
braces	races
brachet	rachet
brachets	rachets
brachial	rachial
bracing	racing
bracings	racings
bracket	racket
bracketed	racketed
bracketing	racketing
brackets	rackets
brad	rad
bradded	radded
bradding	radding
brads	rads
brag	rag
bragged	ragged
bragging	ragging
braggy	raggy
brags	rags
braid	raid
braided	raided
braider	raider
braiders	raiders
braiding	raiding
braids	raids
brail	rail
brailed	railed
brailing	railing
brails	rails
brain	rain
brained	rained
brainier	rainier
brainiest	rainiest
brainily	rainily
braining	raining
brainless	rainless
brains	rains
brainstorm	rainstorm
brainstorms	rainstorms
brainwash	rainwash
brainwashed	rainwashed
brainwashes	rainwashes
brainwashing	rainwashing
brainy	rainy
braise	raise
braised	raised
braises	raises
braising	raising
brake	rake
braked	raked
brakes	rakes
braking	raking
bramble	ramble
brambled	rambled
brambles	rambles
brambling	rambling
bran	ran
branch	ranch
branched	ranched
branches	ranches
branching	ranching
brand	rand
brandies	randies
brands	rands
brandy	randy
brank	rank
branks	ranks
brant	rant
brants	rants
bras	ras
brash	rash
brasher	rasher
brashes	rashes
brashest	rashest
brashly	rashly
brashness	rashness
brashnesses	rashnesses
brat	rat
brats	rats
brattier	rattier
brattiest	rattiest
brattish	rattish
brattle	rattle
brattled	rattled
brattles	rattles
brattling	rattling
bratty	ratty
brave	rave
braved	raved
braver	raver
bravers	ravers
braves	raves
braving	raving
braw	raw
brawer	rawer
brawest	rawest
brawly	rawly
braws	raws
bray	ray
brayed	rayed
braying	raying
brays	rays
braze	raze
brazed	razed
brazer	razer
brazers	razers
brazes	razes
brazing	razing
breach	reach
breached	reached
breacher	reacher
breachers	reachers
breaches	reaches
breaching	reaching
bread	read
breading	reading
breads	reads
bready	ready
bream	ream
breamed	reamed
breaming	reaming
breams	reams
bred	red
brede	rede
bredes	redes
bree	ree
breed	reed
breeding	reeding
breedings	reedings
breeds	reeds
breeks	reeks
brees	rees
bregma	regma
bregmata	regmata
brent	rent
brents	rents
brevet	revet
brevets	revets
brevetted	revetted
brevetting	revetting
brewed	rewed
bribes	ribes
brick	rick
bricked	ricked
bricking	ricking
bricks	ricks
bride	ride
brides	rides
bridge	ridge
bridged	ridged
bridges	ridges
bridging	ridging
brig	rig
bright	right
brighter	righter
brightest	rightest
brightly	rightly
brightness	rightness
brightnesses	rightnesses
brights	rights
brigs	rigs
brill	rill
brills	rills
brim	rim
brimless	rimless
brimmed	rimmed
brimmer	rimmer
brimmers	rimmers
brimming	rimming
brims	rims
brin	rin
brinded	rinded
bring	ring
bringer	ringer
bringers	ringers
bringing	ringing
brings	rings
brink	rink
brinks	rinks
brins	rins
brisk	risk
brisked	risked
brisker	risker
brisking	risking
brisks	risks
broach	roach
broached	roached
broaches	roaches
broaching	roaching
broad	road
broads	roads
broadside	roadside
broadsides	roadsides
brock	rock
brocket	rocket
brockets	rockets
brocks	rocks
brogue	rogue
brogueries	rogueries
broguery	roguery
brogues	rogues
broguish	roguish
broil	roil
broiled	roiled
broiling	roiling
broils	roils
brood	rood
broods	roods
brook	rook
brooked	rooked
brookie	rookie
brookies	rookies
brooking	rooking
brooks	rooks
broom	room
broomed	roomed
broomier	roomier
broomiest	roomiest
brooming	rooming
brooms	rooms
broomy	roomy
brose	rose
broses	roses
brosy	rosy
brow	row
browed	rowed
brows	rows
bruin	ruin
bruins	ruins
brunt	runt
brunts	runts
brush	rush
brushed	rushed
brusher	rusher
brushers	rushers
brushes	rushes
brushier	rushier
brushiest	rushiest
brushing	rushing
brushy	rushy
brusk	rusk
brut	rut
budder	udder
budders	udders
bum	um
bumbles	umbles
bump	ump
bumped	umped
bumping	umping
bumps	umps
bun	un
bunco	unco
buncos	uncos
bunion	union
bunions	unions
buns	uns
burbs	urbs
burd	urd
burds	urds
burger	urger
burgers	urgers
burial	urial
burials	urials
burn	urn
burns	urns
bursa	ursa
bursae	ursae
bus	us
bused	used
buses	uses
busher	usher
bushers	ushers
busing	using
but	ut
bute	ute
buts	uts
butter	utter
buttered	uttered
buttering	uttering
butters	utters
bye	ye
byes	yes
cab	ab
cable	able
cabled	abled
cables	ables
cabs	abs
cache	ache
cached	ached
caches	aches
caching	aching
cad	ad
cads	ads
caff	aff
cage	age
caged	aged
cager	ager
cagers	agers
cages	ages
caging	aging
caid	aid
caids	aids
cain	ain
cains	ains
cairn	airn
cairns	airns
calif	alif
califs	alifs
call	all
callow	allow
calls	alls
calms	alms
cam	am
camas	amas
camass	amass
camasses	amasses
camber	amber
cambers	ambers
camp	amp
camps	amps
can	an
canal	anal
cane	ane
canes	anes
canna	anna
cannas	annas
cannular	annular
canon	anon
cant	ant
canted	anted
cantic	antic
canting	anting
cants	ants
cape	ape
caped	aped
caper	aper
capers	apers
capes	apes
capsidal	apsidal
car	ar
carb	arb
carbs	arbs
care	are
cares	ares
cark	ark
carks	arks
carles	arles
carousal	arousal
carousals	arousals
carouse	arouse
caroused	aroused
carouser	arouser
carousers	arousers
carouses	arouses
carousing	arousing
carrack	arrack
carracks	arracks
cars	ars
carse	arse
carses	arses
cart	art
cartel	artel
cartels	artels
carts	arts
cash	ash
cashed	ashed
cashes	ashes
cashier	ashier
cashing	ashing
cashless	ashless
cask	ask
casked	asked
casking	asking
casks	asks
caster	aster
casters	asters
cat	at
cate	ate
cates	ates
caudad	audad
caught	aught
cauld	auld
cave	ave
caver	aver
cavers	avers
caves	aves
caw	aw
cawed	awed
cawing	awing
cay	ay
cays	ays
cease	ease
ceased	eased
ceases	eases
ceasing	easing
cel	el
cell	ell
cells	ells
cels	els
censure	ensure
censured	ensured
censurer	ensurer
censurers	ensurers
censures	ensures
censuring	ensuring
center	enter
centered	entered
centering	entering
centers	enters
cere	ere
ceros	eros
cerotic	erotic
cess	ess
cesses	esses
chad	had
chadarim	hadarim
chair	hair
chaired	haired
chairs	hairs
challah	hallah
challahs	hallahs
challot	hallot
challoth	halloth
chalutz	halutz
chalutzim	halutzim
cham	ham
chammy	hammy
champer	hamper
champers	hampers
chams	hams
chance	hance
chances	hances
chandler	handler
chandlers	handlers
chang	hang
changed	hanged
changer	hanger
changers	hangers
changing	hanging
changs	hangs
chant	hant
chanted	hanted
chanting	hanting
chants	hants
chao	hao
chap	hap
chapped	happed
chapping	happing
chaps	haps
chard	hard
chards	hards
chare	hare
chared	hared
chares	hares
charing	haring
chark	hark
charked	harked
charking	harking
charks	harks
charm	harm
charmed	harmed
charmer	harmer
charmers	harmers
charming	harming
charmless	harmless
charms	harms
charrier	harrier
charry	harry
chart	hart
charts	harts
chaste	haste
chasten	hasten
chastened	hastened
chastener	hastener
chasteners	hasteners
chastening	hastening
chastens	hastens
chat	hat
chats	hats
chatted	hatted
chatter	hatter
chatters	hatters
chatting	hatting
chaunt	haunt
chaunted	haunted
chaunter	haunter
chaunters	haunters
chaunting	haunting
chaunts	haunts
chaw	haw
chawed	hawed
chawing	hawing
chaws	haws
chay	hay
chays	hays
chazan	hazan
chazanim	hazanim
chazans	hazans
chazzan	hazzan
chazzanim	hazzanim
chazzans	hazzans
cheap	heap
cheaps	heaps
cheat	heat
cheated	heated
cheater	heater
cheaters	heaters
cheating	heating
cheats	heats
check	heck
checks	hecks
cheder	heder
cheders	heders
chemic	hemic
cherries	herries
cherry	herry
chest	hest
chests	hests
cheth	heth
cheths	heths
chew	hew
chewable	hewable
chewed	hewed
chewer	hewer
chewers	hewers
chewing	hewing
chews	hews
chi	hi
chic	hic
chick	hick
chickories	hickories
chickory	hickory
chicks	hicks
chid	hid
chidden	hidden
chide	hide
chided	hided
chider	hider
chiders	hiders
chides	hides
chiding	hiding
childing	hilding
chili	hili
chill	hill
chilled	hilled
chiller	hiller
chillers	hillers
chillier	hillier
chilliest	hilliest
chilling	hilling
chills	hills
chilly	hilly
chin	hin
chinkier	hinkier
chinkiest	hinkiest
chins	hins
chints	hints
chip	hip
chipped	hipped
chipper	hipper
chippie	hippie
chippier	hippier
chippies	hippies
chippiest	hippiest
chipping	hipping
chippy	hippy
chips	hips
chis	his
chit	hit
chits	hits
chitter	hitter
chitters	hitters
chive	hive
chives	hives
chock	hock
chocked	hocked
chocking	hocking
chocks	hocks
choke	hoke
choked	hoked
chokes	hokes
chokey	hokey
chokier	hokier
chokiest	hokiest
choking	hoking
cholla	holla
chollas	hollas
chon	hon
chook	hook
chooks	hooks
chop	hop
chopped	hopped
chopper	hopper
choppers	hoppers
choppier	hoppier
choppiest	hoppiest
chopping	hopping
choppy	hoppy
chops	hops
choral	horal
chorded	horded
chording	hording
chose	hose
chosen	hosen
choses	hoses
chouse	house
choused	housed
chouser	houser
chousers	housers
chouses	houses
chousing	housing
chow	how
chows	hows
chub	hub
chubby	hubby
chubs	hubs
chuck	huck
chuckle	huckle
chuckles	huckles
chucks	hucks
chuff	huff
chuffed	huffed
chuffier	huffier
chuffiest	huffiest
chuffing	huffing
chuffs	huffs
chuffy	huffy
chug	hug
chugged	hugged
chugger	hugger
chuggers	huggers
chugging	hugging
chugs	hugs
chum	hum
chummed	hummed
chumming	humming
chump	hump
chumped	humped
chumping	humping
chumps	humps
chums	hums
chunk	hunk
chunkier	hunkier
chunkiest	hunkiest
chunks	hunks
chunky	hunky
chunter	hunter
chunters	hunters
churl	hurl
churls	hurls
chutzpa	hutzpa
chutzpah	hutzpah
chutzpahs	hutzpahs
chutzpas	hutzpas
cilia	ilia
cilium	ilium
cinch	inch
cinched	inched
cinches	inches
cinching	inching
cion	ion
cions	ions
cire	ire
cires	ires
cis	is
citer	iter
cither	ither
civies	ivies
clack	lack
clacked	lacked
clacker	lacker
clackers	lackers
clacking	lacking
clacks	lacks
clad	lad
clade	lade
clades	lades
clads	lads
clag	lag
clagged	lagged
clagging	lagging
clags	lags
clam	lam
clamber	lamber
clambers	lambers
clammed	lammed
clamming	lamming
clamp	lamp
clamped	lamped
clampers	lampers
clamping	lamping
clamps	lamps
clams	lams
clang	lang
clank	lank
clap	lap
clapboard	lapboard
clapboards	lapboards
clapped	lapped
clapper	lapper
clappers	lappers
clapping	lapping
claps	laps
clash	lash
clashed	lashed
clasher	lasher
clashers	lashers
clashes	lashes
clashing	lashing
class	lass
classes	lasses
clast	last
clasts	lasts
clatter	latter
clave	lave
claver	laver
clavers	lavers
claves	laves
claw	law
clawed	lawed
clawing	lawing
clawless	lawless
clawlike	lawlike
claws	laws
clay	lay
clayed	layed
claying	laying
clays	lays
clean	lean
cleaned	leaned
cleaner	leaner
cleaners	leaners
cleanest	leanest
cleaning	leaning
cleanly	leanly
cleanness	leanness
cleannesses	leannesses
cleans	leans
clear	lear
clears	lears
cleave	leave
cleaved	leaved
cleaver	leaver
cleavers	leavers
cleaves	leaves
cleaving	leaving
cleek	leek
cleeks	leeks
cleft	left
clefts	lefts
clept	lept
clever	lever
cliches	liches
click	lick
clicked	licked
clicker	licker
clickers	lickers
clicking	licking
clicks	licks
clift	lift
clifts	lifts
climb	limb
climbed	limbed
climber	limber
climbers	limbers
climbing	limbing
climbs	limbs
clime	lime
climes	limes
cline	line
clines	lines
cling	ling
clinger	linger
clingers	lingers
clingier	lingier
clingiest	lingiest
clings	lings
clingy	lingy
clink	link
clinked	linked
clinker	linker
clinkers	linkers
clinking	linking
clinks	links
clip	lip
clipped	lipped
clipper	lipper
clippers	lippers
clipping	lipping
clippings	lippings
clips	lips
clitoral	litoral
clivers	livers
clobber	lobber
clobbers	lobbers
clock	lock
clocked	locked
clocker	locker
clockers	lockers
clocking	locking
clocks	locks
clog	log
clogged	logged
clogger	logger
cloggers	loggers
cloggier	loggier
cloggiest	loggiest
clogging	logging
cloggy	loggy
clogs	logs
clone	lone
cloner	loner
cloners	loners
cloot	loot
cloots	loots
clop	lop
clopped	lopped
clopping	lopping
clops	lops
closable	losable
close	lose
closer	loser
closers	losers
closes	loses
closing	losing
closings	losings
clot	lot
cloth	loth
clots	lots
clotted	lotted
clotting	lotting
cloud	loud
clough	lough
cloughs	loughs
clour	lour
cloured	loured
clouring	louring
clours	lours
clout	lout
clouted	louted
clouting	louting
clouts	louts
clove	love
clover	lover
clovers	lovers
cloves	loves
clown	lown
clubber	lubber
clubbers	lubbers
cluck	luck
clucked	lucked
clucking	lucking
clucks	lucks
clues	lues
clumber	lumber
clumbers	lumbers
clump	lump
clumped	lumped
clumpier	lumpier
clumpiest	lumpiest
clumping	lumping
clumpish	lumpish
clumps	lumps
clumpy	lumpy
clung	lung
clunk	lunk
clunker	lunker
clunkers	lunkers
clunks	lunks
cluster	luster
clustered	lustered
clustering	lustering
clusters	lusters
coast	oast
coasts	oasts
coat	oat
coater	oater
coaters	oaters
coats	oats
cobia	obia
cobias	obias
coca	oca
cocas	ocas
cocker	ocker
cockers	ockers
cocreate	ocreate
cod	od
coda	oda
codas	odas
codder	odder
code	ode
codes	odes
cods	ods
coff	off
coffer	offer
coffered	offered
coffering	offering
coffers	offers
coffing	offing
coffs	offs
coft	oft
coho	oho
coil	oil
coiled	oiled
coiler	oiler
coilers	oilers
coiling	oiling
coils	oils
coke	oke
cokes	okes
cold	old
colder	older
coldest	oldest
coldish	oldish
coldness	oldness
coldnesses	oldnesses
colds	olds
cole	ole
coles	oles
comber	omber
combers	ombers
comer	omer
comers	omers
con	on
cone	one
cones	ones
conium	onium
cons	ons
conto	onto
conus	onus
coops	oops
coot	oot
coots	oots
cop	op
copal	opal
copals	opals
cope	ope
coped	oped
copen	open
copens	opens
copes	opes
coping	oping
cops	ops
cor	or
coracle	oracle
coracles	oracles
coral	oral
corals	orals
corby	orby
corder	order
corders	orders
core	ore
cores	ores
cos	os
coses	oses
cosier	osier
cosmic	osmic
cosmoses	osmoses
cottar	ottar
cottars	ottars
cotter	otter
cotters	otters
couch	ouch
couched	ouched
couches	ouches
couching	ouching
couter	outer
couters	outers
coven	oven
covens	ovens
cover	over
coverable	overable
coverage	overage
coverages	overages
coverall	overall
coveralled	overalled
coveralls	overalls
covered	overed
covering	overing
coverlet	overlet
coverlets	overlets
covers	overs
coverslip	overslip
coverslips	overslips
covert	overt
covertly	overtly
covertness	overtness
covertnesses	overtnesses
coverture	overture
covertures	overtures
cow	ow
cowed	owed
cowing	owing
cowl	owl
cowls	owls
cox	ox
coxes	oxes
coy	oy
coyer	oyer
crack	rack
cracked	racked
cracker	racker
crackers	rackers
cracking	racking
crackle	rackle
cracks	racks
craft	raft
crafted	rafted
crafting	rafting
crafts	rafts
craftsman	raftsman
craftsmen	raftsmen
crag	rag
cragged	ragged
craggy	raggy
crags	rags
crake	rake
crakes	rakes
cram	ram
crammed	rammed
crammer	rammer
crammers	rammers
cramming	ramming
cramp	ramp
cramped	ramped
cramping	ramping
cramps	ramps
crams	rams
cranch	ranch
cranched	ranched
cranches	ranches
cranching	ranching
crank	rank
cranked	ranked
cranker	ranker
crankest	rankest
cranking	ranking
crankish	rankish
crankle	rankle
crankled	rankled
crankles	rankles
crankling	rankling
crankly	rankly
cranks	ranks
crap	rap
crape	rape
craped	raped
crapes	rapes
craping	raping
crapped	rapped
crapper	rapper
crappers	rappers
crapping	rapping
craps	raps
crases	rases
crash	rash
crasher	rasher
crashers	rashers
crashes	rashes
cratch	ratch
cratches	ratches
crate	rate
crated	rated
crater	rater
craters	raters
crates	rates
crating	rating
craunch	raunch
craunches	raunches
crave	rave
craved	raved
craven	raven
cravened	ravened
cravening	ravening
cravens	ravens
craver	raver
cravers	ravers
craves	raves
craving	raving
cravings	ravings
craw	raw
crawly	rawly
craws	raws
crayon	rayon
crayons	rayons
craze	raze
crazed	razed
crazes	razes
crazing	razing
cream	ream
creamed	reamed
creamer	reamer
creamers	reamers
creaming	reaming
creams	reams
cred	red
credo	redo
credos	redos
creed	reed
creeds	reeds
creek	reek
creeks	reeks
creel	reel
creeled	reeled
creeling	reeling
creels	reels
cremains	remains
cremate	remate
cremated	remated
cremates	remates
cremating	remating
crest	rest
crested	rested
cresting	resting
crestless	restless
crests	rests
crewed	rewed
crib	rib
cribbed	ribbed
cribber	ribber
cribbers	ribbers
cribbing	ribbing
cribbings	ribbings
cribs	ribs
crick	rick
cricked	ricked
crickets	rickets
crickey	rickey
cricking	ricking
cricks	ricks
crime	rime
crimes	rimes
crimmer	rimmer
crimmers	rimmers
crimple	rimple
crimpled	rimpled
crimples	rimples
crimpling	rimpling
cringed	ringed
cringer	ringer
cringers	ringers
cringing	ringing
cripe	ripe
cripes	ripes
cripple	ripple
crippled	rippled
crippler	rippler
cripplers	ripplers
cripples	ripples
crippling	rippling
crises	rises
critter	ritter
critters	ritters
croc	roc
crochet	rochet
crochets	rochets
crock	rock
crocked	rocked
crockeries	rockeries
crockery	rockery
crocket	rocket
crocketed	rocketed
crockets	rockets
crocking	rocking
crocks	rocks
crocs	rocs
crook	rook
crooked	rooked
crookeries	rookeries
crookery	rookery
crooking	rooking
crooks	rooks
croquet	roquet
croqueted	roqueted
croqueting	roqueting
croquets	roquets
crosier	rosier
crotch	rotch
crotches	rotches
crouches	rouches
croup	roup
croupier	roupier
croupiest	roupiest
croupily	roupily
croups	roups
croupy	roupy
crouse	rouse
crow	row
crowdies	rowdies
crowdy	rowdy
crowed	rowed
crower	rower
crowers	rowers
crowing	rowing
crows	rows
cruck	ruck
crucks	rucks
cruddier	ruddier
cruddiest	ruddiest
cruddy	ruddy
crude	rude
crudely	rudely
crudeness	rudeness
crudenesses	rudenesses
cruder	ruder
crudest	rudest
crumble	rumble
crumbled	rumbled
crumbles	rumbles
crumbling	rumbling
crumblings	rumblings
crumbly	rumbly
crummier	rummier
crummies	rummies
crummiest	rummiest
crummy	rummy
crump	rump
crumple	rumple
crumpled	rumpled
crumples	rumples
crumplier	rumplier
crumpliest	rumpliest
crumpling	rumpling
crumply	rumply
crumps	rumps
crural	rural
cruse	ruse
cruses	ruses
crush	rush
crushed	rushed
crusher	rusher
crushers	rushers
crushes	rushes
crushing	rushing
crust	rust
crusted	rusted
crustier	rustier
crustiest	rustiest
crustily	rustily
crustiness	rustiness
crustinesses	rustinesses
crusting	rusting
crustless	rustless
crusts	rusts
crusty	rusty
cuke	uke
cukes	ukes
cumber	umber
cumbered	umbered
cumbering	umbering
cumbers	umbers
cuniform	uniform
cuniforms	uniforms
cup	up
cupbearer	upbearer
cupbearers	upbearers
cupped	upped
cupper	upper
cuppers	uppers
cupping	upping
cuppings	uppings
cups	ups
curare	urare
curares	urares
curari	urari
curaris	uraris
curate	urate
curates	urates
curb	urb
curbs	urbs
curd	urd
curds	urds
curial	urial
curn	urn
curns	urns
cut	ut
cute	ute
cutes	utes
cuts	uts
cutter	utter
cutters	utters
cyeses	yeses
dab	ab
dabs	abs
dace	ace
daces	aces
dad	ad
daddle	addle
daddled	addled
daddles	addles
daddling	addling
dado	ado
dados	ados
dads	ads
daff	aff
daft	aft
dafter	after
dag	ag
dagger	agger
daggers	aggers
dago	ago
dah	ah
dahs	ahs
dairy	airy
dais	ais
dal	al
dale	ale
dales	ales
dalliance	alliance
dalliances	alliances
dallied	allied
dallies	allies
dally	ally
dallying	allying
dals	als
dam	am
damp	amp
damply	amply
damps	amps
danger	anger
dangered	angered
dangering	angering
dangers	angers
dangle	angle
dangled	angled
dangler	angler
danglers	anglers
dangles	angles
dangling	angling
dapple	apple
dapples	apples
darb	arb
darbs	arbs
dare	are
dares	ares
dark	ark
darks	arks
dart	art
darts	arts
dash	ash
dashed	ashed
dashes	ashes
dashier	ashier
dashiest	ashiest
dashing	ashing
dashy	ashy
date	ate
dates	ates
daunt	aunt
daunts	aunts
davens	avens
daw	aw
dawed	awed
dawing	awing
dawn	awn
dawned	awned
dawning	awning
dawns	awns
day	ay
days	ays
dear	ear
dearly	early
dears	ears
dearth	earth
dearths	earths
death	eath
deave	eave
deaved	eaved
deaves	eaves
deduce	educe
deduced	educed
deduces	educes
deducible	educible
deducing	educing
deduct	educt
deduction	eduction
deductions	eductions
deductive	eductive
deducts	educts
def	ef
deft	eft
deject	eject
dejecta	ejecta
dejected	ejected
dejecting	ejecting
dejection	ejection
dejections	ejections
dejects	ejects
deke	eke
deked	eked
dekes	ekes
deking	eking
del	el
delate	elate
delated	elated
delates	elates
delating	elating
delation	elation
delations	elations
delectabilities	electabilities
delectability	electability
delectable	electable
delf	elf
dell	ell
dells	ells
dels	els
delude	elude
deluded	eluded
deluder	eluder
deluders	eluders
deludes	eludes
deluding	eluding
delusion	elusion
delusions	elusions
delusive	elusive
delusively	elusively
delusiveness	elusiveness
delusivenesses	elusivenesses
delusory	elusory
delver	elver
delvers	elvers
delves	elves
deme	eme
demerge	emerge
demerged	emerged
demerges	emerges
demerging	emerging
demes	emes
demission	emission
demissions	emissions
demit	emit
demits	emits
demitted	emitted
demitting	emitting
demote	emote
demoted	emoted
demotes	emotes
demoting	emoting
demotion	emotion
demotions	emotions
den	en
denervate	enervate
denervated	enervated
denervates	enervates
denervating	enervating
denervation	enervation
denervations	enervations
denounce	enounce
denounced	enounced
denounces	enounces
denouncing	enouncing
dens	ens
denumerabilities	enumerabilities
denumerability	enumerability
denumerable	enumerable
denunciation	enunciation
denunciations	enunciations
depilation	epilation
depilations	epilations
deposes	eposes
dere	ere
devaluate	evaluate
devaluated	evaluated
devaluates	evaluates
devaluating	evaluating
devaluation	evaluation
devaluations	evaluations
devil	evil
devils	evils
devolution	evolution
devolutionary	evolutionary
devolutionist	evolutionist
devolutionists	evolutionists
devolutions	evolutions
devolve	evolve
devolved	evolved
devolves	evolves
devolving	evolving
dex	ex
dexes	exes
dhole	hole
dholes	holes
dhooly	hooly
dhow	how
dhows	hows
dhurries	hurries
dice	ice
diced	iced
dices	ices
dicier	icier
diciest	iciest
dicing	icing
dick	ick
dicker	icker
dickers	ickers
dickier	ickier
dickiest	ickiest
dicky	icky
did	id
dif	if
diff	iff
difs	ifs
digged	igged
digging	igging
dignified	ignified
dignifies	ignifies
dignify	ignify
dignifying	ignifying
dill	ill
dills	ills
dilly	illy
dimply	imply
din	in
dingle	ingle
dingles	ingles
dink	ink
dinked	inked
dinkier	inkier
dinkiest	inkiest
dinking	inking
dinks	inks
dinky	inky
dinned	inned
dinner	inner
dinners	inners
dinning	inning
dins	ins
dire	ire
direful	ireful
direfully	irefully
dirk	irk
dirked	irked
dirking	irking
dirks	irks
dis	is
dit	it
ditch	itch
ditched	itched
ditches	itches
ditching	itching
dither	ither
dits	its
djebel	jebel
djebels	jebels
djellaba	jellaba
djellabas	jellabas
djin	jin
djinn	jinn
djinni	jinni
djinns	jinns
djins	jins
doat	oat
doats	oats
docker	ocker
dockers	ockers
dodder	odder
doe	oe
does	oes
doff	off
doffed	offed
doffer	offer
doffers	offers
doffing	offing
doffs	offs
doiled	oiled
doily	oily
dole	ole
doles	oles
doloroso	oloroso
dom	om
doms	oms
don	on
done	one
doneness	oneness
donenesses	onenesses
dons	ons
doodles	oodles
doozy	oozy
dope	ope
doped	oped
dopes	opes
doping	oping
dor	or
dore	ore
dormer	ormer
dormers	ormers
dors	ors
dos	os
dose	ose
doses	oses
dotter	otter
dotters	otters
douched	ouched
douches	ouches
douching	ouching
dought	ought
dour	our
doven	oven
dovens	ovens
dow	ow
dowed	owed
dowing	owing
down	own
downed	owned
downer	owner
downers	owners
downing	owning
downs	owns
dowse	owse
doxy	oxy
drabbet	rabbet
drabbets	rabbets
drabble	rabble
drabbled	rabbled
drabbles	rabbles
drabbling	rabbling
draff	raff
draffish	raffish
draffs	raffs
draft	raft
drafted	rafted
drafter	rafter
drafters	rafters
drafting	rafting
drafts	rafts
draftsman	raftsman
draftsmen	raftsmen
drag	rag
dragee	ragee
dragees	ragees
dragged	ragged
dragging	ragging
draggle	raggle
draggles	raggles
draggy	raggy
drags	rags
drail	rail
drails	rails
drain	rain
drained	rained
draining	raining
drains	rains
drake	rake
drakes	rakes
dram	ram
drammed	rammed
dramming	ramming
drams	rams
drank	rank
drape	rape
draped	raped
draper	raper
drapers	rapers
drapes	rapes
draping	raping
drat	rat
drats	rats
dratted	ratted
dratting	ratting
drave	rave
draw	raw
drawer	rawer
drawly	rawly
draws	raws
dray	ray
drayed	rayed
draying	raying
drays	rays
dread	read
dreading	reading
dreads	reads
dream	ream
dreamed	reamed
dreamer	reamer
dreamers	reamers
dreaming	reaming
dreams	reams
drear	rear
drears	rears
dreck	reck
drecks	recks
dree	ree
dreed	reed
drees	rees
dreg	reg
dregs	regs
drest	rest
drib	rib
dribbed	ribbed
dribbing	ribbing
driblet	riblet
driblets	riblets
dribs	ribs
drift	rift
drifted	rifted
drifting	rifting
drifts	rifts
drill	rill
drilled	rilled
drilling	rilling
drills	rills
drink	rink
drinks	rinks
drip	rip
dripped	ripped
dripper	ripper
drippers	rippers
dripping	ripping
drips	rips
drive	rive
driven	riven
driver	river
drivers	rivers
drives	rives
driving	riving
drogue	rogue
drogues	rogues
droll	roll
drolled	rolled
droller	roller
drolling	rolling
drolls	rolls
drouth	routh
drouths	rouths
drove	rove
droved	roved
drover	rover
drovers	rovers
droves	roves
droving	roving
drub	rub
drubbed	rubbed
drubber	rubber
drubbers	rubbers
drubbing	rubbing
drubbings	rubbings
drubs	rubs
drug	rug
drugged	rugged
drugging	rugging
drugs	rugs
drum	rum
drumble	rumble
drumbled	rumbled
drumbles	rumbles
drumbling	rumbling
drummer	rummer
drummers	rummers
drums	rums
druse	ruse
druses	ruses
dubieties	ubieties
dubiety	ubiety
duh	uh
duke	uke
dukes	ukes
dumber	umber
dump	ump
dumped	umped
dumping	umping
dumps	umps
dun	un
dunite	unite
dunites	unites
duns	uns
dup	up
dupped	upped
dupping	upping
dups	ups
durn	urn
durns	urns
dwell	well
dwelled	welled
dwelling	welling
dwells	wells
dwelt	welt
dwindle	windle
dwindled	windled
dwindles	windles
dwindling	windling
dwine	wine
dwined	wined
dwines	wines
dwining	wining
dye	ye
dyes	yes
eager	ager
eagers	agers
eaglet	aglet
eaglets	aglets
ear	ar
ears	ars
easter	aster
eastern	astern
easters	asters
eat	at
eave	ave
eaves	aves
ebola	bola
ebony	bony
ebook	book
ecarte	carte
ecartes	cartes
ecaudate	caudate
echard	chard
echards	chards
ecotype	cotype
ecotypes	cotypes
ecrus	crus
edentate	dentate
edentulous	dentulous
edit	dit
edits	dits
educe	duce
educes	duces
educt	duct
educts	ducts
eel	el
eels	els
egad	gad
egads	gads
egal	gal
egest	gest
egests	gests
ego	go
eikon	ikon
eikons	ikons
eirenic	irenic
either	ither
ejaculate	jaculate
ejaculated	jaculated
ejaculates	jaculates
ejaculating	jaculating
eked	ked
eking	king
elain	lain
eland	land
elands	lands
elapse	lapse
elapsed	lapsed
elapses	lapses
elapsing	lapsing
elate	late
elated	lated
elater	later
elaterite	laterite
elaterites	laterites
election	lection
elections	lections
elector	lector
electors	lectors
elegist	legist
elegists	legists
elegit	legit
elegits	legits
elevator	levator
elevators	levators
elicit	licit
elint	lint
elints	lints
elite	lite
elocution	locution
elocutions	locutions
eloin	loin
eloins	loins
elope	lope
eloped	loped
eloper	loper
elopers	lopers
elopes	lopes
eloping	loping
elucubration	lucubration
elucubrations	lucubrations
elude	lude
eludes	ludes
elute	lute
eluted	luted
elutes	lutes
eluting	luting
email	mail
emailed	mailed
emarginate	marginate
emargination	margination
emarginations	marginations
eme	me
emend	mend
emendable	mendable
emended	mended
emender	mender
emenders	menders
emending	mending
emends	mends
emerge	merge
emerged	merged
emergence	mergence
emergences	mergences
emerges	merges
emerging	merging
emic	mic
emigrant	migrant
emigrants	migrants
emigrate	migrate
emigrated	migrated
emigrates	migrates
emigrating	migrating
emigration	migration
emigrations	migrations
emir	mir
emirs	mirs
emission	mission
emissions	missions
emissive	missive
emote	mote
emotes	motes
emotion	motion
emotional	motional
emotionless	motionless
emotionlessly	motionlessly
emotionlessness	motionlessness
emotionlessnesses	motionlessnesses
emotions	motions
emotive	motive
emotivities	motivities
emotivity	motivity
emu	mu
emus	mus
enates	nates
enation	nation
enations	nations
enema	nema
enemas	nemas
enervate	nervate
enervation	nervation
enervations	nervations
enorm	norm
enow	now
enows	nows
enucleate	nucleate
enucleated	nucleated
enucleates	nucleates
enucleating	nucleating
enucleation	nucleation
enucleations	nucleations
enumerable	numerable
enumerate	numerate
enumerated	numerated
enumerates	numerates
enumerating	numerating
enumeration	numeration
enumerations	numerations
enumerator	numerator
enumerators	numerators
eon	on
eons	ons
epact	pact
epacts	pacts
eparch	parch
epee	pee
epees	pees
ephorate	phorate
ephorates	phorates
epic	pic
epical	pical
epicritic	picritic
epics	pics
eposes	poses
epoxy	poxy
equalities	qualities
equality	quality
equate	quate
equid	quid
equids	quids
equip	quip
equipped	quipped
equipper	quipper
equippers	quippers
equipping	quipping
equips	quips
eradiate	radiate
eradiated	radiated
eradiates	radiates
eradiating	radiating
eradicate	radicate
eradicated	radicated
eradicates	radicates
eradicating	radicating
eras	ras
erase	rase
erased	rased
eraser	raser
erasers	rasers
erases	rases
erasing	rasing
erasure	rasure
erasures	rasures
ere	re
erector	rector
erectors	rectors
erode	rode
erodent	rodent
erose	rose
eroses	roses
escalade	scalade
escalades	scalades
escallop	scallop
escalloped	scalloped
escalloping	scalloping
escallops	scallops
escape	scape
escaped	scaped
escapes	scapes
escaping	scaping
escar	scar
escarp	scarp
escarped	scarped
escarping	scarping
escarps	scarps
escars	scars
escot	scot
escots	scots
escudo	scudo
escutcheon	scutcheon
escutcheons	scutcheons
eserine	serine
eserines	serines
especial	special
especially	specially
espied	spied
espies	spies
espousal	spousal
espousals	spousals
espouse	spouse
espoused	spoused
espouses	spouses
espousing	spousing
esprit	sprit
esprits	sprits
espy	spy
espying	spying
esquire	squire
esquired	squired
esquires	squires
esquiring	squiring
establish	stablish
established	stablished
establishes	stablishes
establishing	stablishing
establishment	stablishment
establishments	stablishments
estate	state
estated	stated
estates	states
estating	stating
estop	stop
estopped	stopped
estopping	stopping
estops	stops
estovers	stovers
estrange	strange
estranger	stranger
estrangers	strangers
estray	stray
estrayed	strayed
estraying	straying
estrays	strays
estrum	strum
estrums	strums
eta	ta
etalon	talon
etalons	talons
etape	tape
etapes	tapes
etas	tas
eterne	terne
ethane	thane
ethanes	thanes
ethionine	thionine
ethionines	thionines
etic	tic
etoile	toile
etoiles	toiles
etui	tui
etuis	tuis
etwee	twee
euphroe	uphroe
euphroes	uphroes
evaluate	valuate
evaluated	valuated
evaluates	valuates
evaluating	valuating
evaluation	valuation
evaluations	valuations
evaluator	valuator
evaluators	valuators
evanish	vanish
evanished	vanished
evanishes	vanishes
evanishing	vanishing
event	vent
eventless	ventless
events	vents
eversion	version
eversions	versions
evert	vert
everts	verts
every	very
evictor	victor
evictors	victors
eviler	viler
evilest	vilest
evincible	vincible
evocable	vocable
evocation	vocation
evocations	vocations
evocative	vocative
evocatively	vocatively
evolute	volute
evolutes	volutes
evolution	volution
evolutions	volutions
ewe	we
eye	ye
eyen	yen
eyes	yes
fab	ab
fable	able
fabled	abled
fabler	abler
fables	ables
face	ace
faced	aced
faces	aces
facing	acing
fact	act
faction	action
factions	actions
factor	actor
factors	actors
facts	acts
factual	actual
factualities	actualities
factuality	actuality
factually	actually
fad	ad
fado	ado
fados	ados
fads	ads
faerie	aerie
faeries	aeries
faery	aery
fail	ail
failed	ailed
failing	ailing
fails	ails
fain	ain
fair	air
faired	aired
fairer	airer
fairest	airest
fairing	airing
fairings	airings
fairs	airs
fairway	airway
fairways	airways
fairy	airy
fall	all
fallow	allow
fallowed	allowed
fallowing	allowing
fallows	allows
falls	alls
falter	alter
faltered	altered
falterer	alterer
falterers	alterers
faltering	altering
falters	alters
famine	amine
famines	amines
fan	an
fane	ane
fanes	anes
fanga	anga
fangas	angas
fanion	anion
fanions	anions
fanon	anon
far	ar
farced	arced
farcing	arcing
fare	are
fares	ares
farles	arles
farm	arm
farmed	armed
farmer	armer
farmers	armers
farming	arming
farmings	armings
farms	arms
farrow	arrow
farrowed	arrowed
farrowing	arrowing
farrows	arrows
fart	art
farts	arts
fas	as
fash	ash
fashed	ashed
fashes	ashes
fashing	ashing
faster	aster
fat	at
fate	ate
fates	ates
fattest	attest
fauld	auld
fava	ava
fave	ave
faves	aves
fawn	awn
fawned	awned
fawning	awning
fawns	awns
fawny	awny
fax	ax
faxed	axed
faxes	axes
faxing	axing
fay	ay
fays	ays
fear	ear
feared	eared
fearful	earful
fearing	earing
fearless	earless
fears	ears
fease	ease
feased	eased
feases	eases
feasing	easing
feast	east
feaster	easter
feasters	easters
feasting	easting
feasts	easts
feat	eat
feater	eater
feats	eats
fed	ed
feel	eel
feels	eels
feh	eh
felicitation	elicitation
felicitations	elicitations
fell	ell
fells	ells
fem	em
feme	eme
femes	emes
fems	ems
fen	en
fend	end
fended	ended
fender	ender
fenders	enders
fending	ending
fends	ends
fens	ens
fer	er
fere	ere
fern	ern
ferns	erns
fess	ess
fesses	esses
fester	ester
festers	esters
festival	estival
fet	et
feta	eta
fetas	etas
fetch	etch
fetched	etched
fetcher	etcher
fetchers	etchers
fetches	etches
fetching	etching
fever	ever
fewer	ewer
feyer	eyer
fice	ice
fices	ices
fid	id
fids	ids
figged	igged
figging	igging
filial	ilial
fill	ill
filler	iller
fills	ills
filly	illy
fin	in
finch	inch
finches	inches
fink	ink
finked	inked
finking	inking
finks	inks
finned	inned
finning	inning
fins	ins
fire	ire
fired	ired
fireless	ireless
fires	ires
firing	iring
fit	it
fitch	itch
fitches	itches
fitchy	itchy
fits	its
flab	lab
flabella	labella
flabellum	labellum
flabs	labs
flack	lack
flacked	lacked
flacking	lacking
flacks	lacks
flag	lag
flagged	lagged
flagger	lagger
flaggers	laggers
flagging	lagging
flaggings	laggings
flags	lags
flair	lair
flairs	lairs
flake	lake
flaked	laked
flaker	laker
flakers	lakers
flakes	lakes
flakier	lakier
flakiest	lakiest
flaking	laking
flaky	laky
flam	lam
flame	lame
flamed	lamed
flamer	lamer
flames	lames
flaming	laming
flammed	lammed
flamming	lamming
flams	lams
flanes	lanes
flank	lank
flanker	lanker
flap	lap
flapped	lapped
flapper	lapper
flappers	lappers
flapping	lapping
flaps	laps
flares	lares
flash	lash
flashed	lashed
flasher	lasher
flashers	lashers
flashes	lashes
flashing	lashing
flashings	lashings
flat	lat
flats	lats
flatten	latten
flattens	lattens
flatter	latter
flaw	law
flawed	lawed
flawing	lawing
flawless	lawless
flawlessly	lawlessly
flawlessness	lawlessness
flawlessnesses	lawlessnesses
flaws	laws
flax	lax
flay	lay
flayed	layed
flayer	layer
flayers	layers
flaying	laying
flays	lays
flea	lea
fleas	leas
fleches	leches
flection	lection
flections	lections
fled	led
fledge	ledge
fledges	ledges
fledgier	ledgier
fledgiest	ledgiest
fledgy	ledgy
flee	lee
fleech	leech
fleeched	leeched
fleeches	leeches
fleeching	leeching
fleer	leer
fleered	leered
fleering	leering
fleeringly	leeringly
fleers	leers
flees	lees
fleet	leet
fleets	leets
flense	lense
flensed	lensed
flenses	lenses
flensing	lensing
fletch	letch
fletched	letched
fletches	letches
fletching	letching
flex	lex
flexes	lexes
fley	ley
fleys	leys
flick	lick
flicked	licked
flicker	licker
flickers	lickers
flicking	licking
flicks	licks
flied	lied
flier	lier
fliers	liers
flies	lies
flight	light
flighted	lighted
flighting	lighting
flightless	lightless
flights	lights
fling	ling
flinger	linger
flingers	lingers
flings	lings
flint	lint
flintier	lintier
flintiest	lintiest
flints	lints
flinty	linty
flip	lip
flipped	lipped
flipper	lipper
flippers	lippers
flipping	lipping
flippy	lippy
flips	lips
flit	lit
flite	lite
flits	lits
flitter	litter
flittered	littered
flittering	littering
flitters	litters
flock	lock
flocked	locked
flocking	locking
flocks	locks
flog	log
flogged	logged
flogger	logger
floggers	loggers
flogging	logging
floggings	loggings
flogs	logs
flong	long
flongs	longs
flooey	looey
flooie	looie
flop	lop
flopped	lopped
flopper	lopper
floppers	loppers
floppier	loppier
floppiest	loppiest
flopping	lopping
floppy	loppy
flops	lops
floral	loral
floss	loss
flosses	losses
flossy	lossy
flota	lota
flotas	lotas
flour	lour
floured	loured
flouring	louring
flours	lours
floury	loury
flout	lout
flouted	louted
flouting	louting
flouts	louts
flow	low
flowed	lowed
flower	lower
flowered	lowered
flowering	lowering
flowers	lowers
flowery	lowery
flowing	lowing
flown	lown
flows	lows
flubber	lubber
flubbers	lubbers
flues	lues
fluff	luff
fluffed	luffed
fluffing	luffing
fluffs	luffs
flummox	lummox
flummoxes	lummoxes
flump	lump
flumped	lumped
flumping	lumping
flumps	lumps
flung	lung
flunk	lunk
flunker	lunker
flunkers	lunkers
flunks	lunks
flush	lush
flushed	lushed
flusher	lusher
flushes	lushes
flushest	lushest
flushing	lushing
flushness	lushness
flushnesses	lushnesses
fluster	luster
flustered	lustered
flustering	lustering
flusters	lusters
flute	lute
fluted	luted
flutes	lutes
fluting	luting
flutings	lutings
flutist	lutist
flutists	lutists
flux	lux
fluxes	luxes
flying	lying
flyings	lyings
fodder	odder
foe	oe
foes	oes
foh	oh
foil	oil
foiled	oiled
foiling	oiling
foils	oils
fold	old
folder	older
folds	olds
folio	olio
folios	olios
fon	on
fons	ons
foot	oot
foots	oots
fop	op
fops	ops
for	or
fora	ora
forb	orb
forbs	orbs
forby	orby
fordo	ordo
fore	ore
fores	ores
forgone	orgone
former	ormer
formers	ormers
fort	ort
forts	orts
fossa	ossa
fought	ought
four	our
fours	ours
fowl	owl
fowls	owls
fox	ox
foxes	oxes
foxtail	oxtail
foxtails	oxtails
foxy	oxy
foy	oy
foyer	oyer
foyers	oyers
frag	rag
fragged	ragged
fragging	ragging
frags	rags
frail	rail
frailer	railer
frails	rails
fraise	raise
fraises	raises
frank	rank
franked	ranked
franker	ranker
frankers	rankers
frankest	rankest
franking	ranking
frankly	rankly
frankness	rankness
franknesses	ranknesses
franks	ranks
frap	rap
frapped	rapped
frapping	rapping
fraps	raps
frat	rat
frater	rater
fraters	raters
frats	rats
fray	ray
frayed	rayed
fraying	raying
frays	rays
free	ree
freed	reed
freedman	reedman
freedmen	reedmen
frees	rees
freest	reest
fresh	resh
freshes	reshes
fret	ret
frets	rets
fretted	retted
fretting	retting
fridge	ridge
fridges	ridges
frig	rig
frigged	rigged
frigging	rigging
fright	right
frighted	righted
frightful	rightful
frightfully	rightfully
frightfulness	rightfulness
frightfulnesses	rightfulnesses
frighting	righting
frights	rights
frigid	rigid
frigidities	rigidities
frigidity	rigidity
frigidly	rigidly
frigidness	rigidness
frigidnesses	rigidnesses
frigs	rigs
frill	rill
frilled	rilled
frilling	rilling
frills	rills
fringed	ringed
fringing	ringing
frise	rise
frises	rises
frisk	risk
frisked	risked
frisker	risker
friskers	riskers
friskier	riskier
friskiest	riskiest
friskily	riskily
friskiness	riskiness
friskinesses	riskinesses
frisking	risking
frisks	risks
frisky	risky
fritter	ritter
fritters	ritters
fritz	ritz
fritzes	ritzes
frock	rock
frocked	rocked
frocking	rocking
frocks	rocks
froe	roe
froes	roes
from	rom
frow	row
frows	rows
frug	rug
frugal	rugal
frugged	rugged
frugging	rugging
frugs	rugs
frump	rump
frumps	rumps
fumbles	umbles
fun	un
function	unction
functions	unctions
funfair	unfair
funs	uns
fuse	use
fused	used
fuseless	useless
fuses	uses
fusing	using
futile	utile
futilitarian	utilitarian
futilitarianism	utilitarianism
futilitarianisms	utilitarianisms
futilitarians	utilitarians
futilities	utilities
futility	utility
gab	ab
gable	able
gabled	abled
gables	ables
gaboon	aboon
gabs	abs
gaby	aby
gad	ad
gadded	added
gadder	adder
gadders	adders
gadding	adding
gads	ads
gae	ae
gaff	aff
gag	ag
gaga	aga
gage	age
gaged	aged
gager	ager
gagers	agers
gages	ages
gagger	agger
gaggers	aggers
gaging	aging
gain	ain
gains	ains
gait	ait
gaits	aits
gal	al
gala	ala
galas	alas
gale	ale
gales	ales
gall	all
galley	alley
galleys	alleys
gallied	allied
gallies	allies
gallium	allium
galliums	alliums
gallows	allows
galls	alls
gally	ally
gallying	allying
gals	als
gam	am
gama	ama
gamas	amas
gambit	ambit
gambits	ambits
gamble	amble
gambled	ambled
gambler	ambler
gamblers	amblers
gambles	ambles
gambling	ambling
gamin	amin
gamine	amine
gamines	amines
gamins	amins
gamp	amp
gamps	amps
gan	an
gane	ane
ganger	anger
gangers	angers
gangling	angling
gantelope	antelope
gantelopes	antelopes
gape	ape
gaped	aped
gaper	aper
gapers	apers
gapes	apes
gaping	aping
gar	ar
garb	arb
garbs	arbs
gargle	argle
gargled	argled
gargles	argles
gargling	argling
gars	ars
gas	as
gash	ash
gashed	ashed
gashes	ashes
gashing	ashing
gasking	asking
gaskings	askings
gasp	asp
gasper	asper
gaspers	aspers
gasps	asps
gasses	asses
gaster	aster
gasters	asters
gastral	astral
gastronomic	astronomic
gastronomical	astronomical
gastronomically	astronomically
gastronomies	astronomies
gastronomy	astronomy
gat	at
gate	ate
gates	ates
gauger	auger
gaugers	augers
gaunt	aunt
gauntly	auntly
gave	ave
gay	ay
gays	ays
gear	ear
geared	eared
gearing	earing
gearings	earings
gearless	earless
gears	ears
ged	ed
geek	eek
gel	el
gelate	elate
gelated	elated
gelates	elates
gelating	elating
gelation	elation
gelations	elations
geld	eld
gelder	elder
gelders	elders
gelds	elds
gels	els
gem	em
gemmy	emmy
gemote	emote
gemotes	emotes
gems	ems
gen	en
gender	ender
genders	enders
gens	ens
gentries	entries
gentry	entry
gestate	estate
gestated	estated
gestates	estates
gestating	estating
get	et
geta	eta
getas	etas
gharries	harries
gharry	harry
ghast	hast
ghat	hat
ghats	hats
ghaut	haut
ghi	hi
ghis	his
ghost	host
ghosted	hosted
ghosting	hosting
ghostly	hostly
ghosts	hosts
gid	id
gids	ids
gigged	igged
gigging	igging
gill	ill
giller	iller
gills	ills
gilly	illy
gimmies	immies
gimp	imp
gimped	imped
gimping	imping
gimps	imps
gin	in
gink	ink
ginks	inks
ginned	inned
ginner	inner
ginners	inners
ginning	inning
ginnings	innings
gins	ins
giron	iron
girons	irons
git	it
gits	its
gizzard	izzard
gizzards	izzards
glabella	labella
glace	lace
glaces	laces
glacier	lacier
glad	lad
gladder	ladder
glade	lade
glades	lades
glads	lads
glady	lady
glair	lair
glaired	laired
glairing	lairing
glairs	lairs
glam	lam
glance	lance
glanced	lanced
glancer	lancer
glancers	lancers
glances	lances
glancing	lancing
gland	land
glanders	landers
glandless	landless
glands	lands
glares	lares
glass	lass
glasses	lasses
glassie	lassie
glassies	lassies
glaze	laze
glazed	lazed
glazes	lazes
glazier	lazier
glaziest	laziest
glazing	lazing
glazy	lazy
glean	lean
gleaned	leaned
gleaner	leaner
gleaners	leaners
gleaning	leaning
gleanings	leanings
gleans	leans
gled	led
glede	lede
glee	lee
gleek	leek
gleeks	leeks
glees	lees
gleet	leet
gleets	leets
gleg	leg
glens	lens
gley	ley
gleys	leys
glib	lib
glibber	libber
glime	lime
glimed	limed
glimes	limes
gliming	liming
glimmer	limmer
glimmers	limmers
glint	lint
glints	lints
glisten	listen
glistened	listened
glistening	listening
glistens	listens
glister	lister
glisters	listers
glitter	litter
glittered	littered
glittering	littering
glitters	litters
glittery	littery
gloam	loam
gloaming	loaming
gloams	loams
glob	lob
globate	lobate
globated	lobated
globby	lobby
globe	lobe
globed	lobed
globes	lobes
globs	lobs
globular	lobular
globule	lobule
globules	lobules
gloom	loom
gloomed	loomed
glooming	looming
glooms	looms
glop	lop
glopped	lopped
glopping	lopping
gloppy	loppy
glops	lops
glories	lories
glory	lory
gloss	loss
glosses	losses
glossy	lossy
glost	lost
glout	lout
glouted	louted
glouting	louting
glouts	louts
glove	love
gloved	loved
glover	lover
glovers	lovers
gloves	loves
gloving	loving
glow	low
glowed	lowed
glower	lower
glowered	lowered
glowering	lowering
glowers	lowers
glowing	lowing
glows	lows
glues	lues
glug	lug
glugged	lugged
glugging	lugging
glugs	lugs
glum	lum
glumpier	lumpier
glumpiest	lumpiest
glumpily	lumpily
glumpy	lumpy
glunch	lunch
glunched	lunched
glunches	lunches
glunching	lunching
glute	lute
gluteal	luteal
gnattier	nattier
gnattiest	nattiest
gnatty	natty
gnaw	naw
gnome	nome
gnomes	nomes
gnoses	noses
gnu	nu
gnus	nus
goat	oat
goatlike	oatlike
goats	oats
goboes	oboes
god	od
gods	ods
goes	oes
goffer	offer
goffered	offered
goffering	offering
goffers	offers
gold	old
golden	olden
golder	older
goldest	oldest
golds	olds
gone	one
goneness	oneness
gonenesses	onenesses
gonion	onion
gonium	onium
goops	oops
gor	or
goral	oral
gorals	orals
gore	ore
gores	ores
gout	out
gouts	outs
gown	own
gowned	owned
gowning	owning
gowns	owns
gox	ox
goxes	oxes
goy	oy
grabble	rabble
grabbled	rabbled
grabbler	rabbler
grabblers	rabblers
grabbles	rabbles
grabbling	rabbling
grace	race
graced	raced
graces	races
gracing	racing
grackle	rackle
grad	rad
gradiometer	radiometer
gradiometers	radiometers
grads	rads
graft	raft
grafted	rafted
grafter	rafter
grafters	rafters
grafting	rafting
grafts	rafts
grail	rail
grails	rails
grain	rain
grained	rained
grainier	rainier
grainiest	rainiest
graining	raining
grains	rains
grainy	rainy
gram	ram
gramp	ramp
gramps	ramps
grams	rams
gran	ran
grand	rand
grands	rands
grange	range
granger	ranger
grangers	rangers
granges	ranges
grant	rant
granted	ranted
granter	ranter
granters	ranters
granting	ranting
grants	rants
grape	rape
grapes	rapes
grapier	rapier
grasp	rasp
grasped	rasped
grasper	rasper
graspers	raspers
grasping	rasping
graspingly	raspingly
grasps	rasps
grat	rat
grate	rate
grated	rated
grater	rater
graters	raters
grates	rates
gratification	ratification
gratifications	ratifications
gratified	ratified
gratifies	ratifies
gratify	ratify
gratifying	ratifying
gratine	ratine
grating	rating
gratings	ratings
grave	rave
graved	raved
gravel	ravel
graveled	raveled
graveling	raveling
gravelled	ravelled
gravelling	ravelling
gravelly	ravelly
gravels	ravels
graven	raven
graver	raver
gravers	ravers
graves	raves
graving	raving
gray	ray
grayed	rayed
graying	raying
grays	rays
graze	raze
grazed	razed
grazer	razer
grazers	razers
grazes	razes
grazing	razing
greave	reave
greaved	reaved
greaves	reaves
gree	ree
greed	reed
greedier	reedier
greediest	reediest
greedily	reedily
greediness	reediness
greedinesses	reedinesses
greeds	reeds
greedy	reedy
greek	reek
greengage	reengage
greengages	reengages
grees	rees
grid	rid
gridder	ridder
gridders	ridders
griddle	riddle
griddled	riddled
griddles	riddles
griddling	riddling
gride	ride
grides	rides
griding	riding
grids	rids
griever	riever
grievers	rievers
griff	riff
griffs	riffs
grift	rift
grifted	rifted
grifting	rifting
grifts	rifts
grig	rig
grigs	rigs
grill	rill
grille	rille
grilled	rilled
grilles	rilles
grilling	rilling
grills	rills
grim	rim
grime	rime
grimed	rimed
grimes	rimes
grimier	rimier
grimiest	rimiest
griminess	riminess
griminesses	riminesses
griming	riming
grimmer	rimmer
grimy	rimy
grin	rin
grind	rind
grinded	rinded
grinds	rinds
grinning	rinning
grins	rins
griot	riot
griots	riots
grip	rip
gripe	ripe
griped	riped
griper	riper
gripes	ripes
griping	riping
gripped	ripped
gripper	ripper
grippers	rippers
gripping	ripping
gripple	ripple
grips	rips
grivet	rivet
grivets	rivets
groan	roan
groans	roans
groom	room
groomed	roomed
groomer	roomer
groomers	roomers
grooming	rooming
grooms	rooms
grope	rope
groped	roped
groper	roper
gropers	ropers
gropes	ropes
groping	roping
grot	rot
grots	rots
grouches	rouches
ground	round
grounded	rounded
grounder	rounder
grounders	rounders
grounding	rounding
grounds	rounds
groundsman	roundsman
groundsmen	roundsmen
groundwood	roundwood
groundwoods	roundwoods
group	roup
grouped	rouped
grouping	rouping
groups	roups
grouse	rouse
groused	roused
grouser	rouser
grousers	rousers
grouses	rouses
grousing	rousing
grout	rout
grouted	routed
grouter	router
grouters	routers
grouting	routing
grouts	routs
grove	rove
groved	roved
groves	roves
grow	row
growable	rowable
grower	rower
growers	rowers
growing	rowing
grows	rows
growth	rowth
growths	rowths
grub	rub
grubbed	rubbed
grubber	rubber
grubbers	rubbers
grubbing	rubbing
grubs	rubs
grue	rue
grues	rues
gruff	ruff
gruffed	ruffed
gruffing	ruffing
gruffly	ruffly
gruffs	ruffs
grum	rum
grumble	rumble
grumbled	rumbled
grumbler	rumbler
grumblers	rumblers
grumbles	rumbles
grumbling	rumbling
grumbly	rumbly
grummer	rummer
grummest	rummest
grump	rump
grumps	rumps
grunt	runt
grunts	runts
gum	um
gumbo	umbo
gumbos	umbos
gun	un
gunfought	unfought
gunite	unite
gunites	unites
gunless	unless
gunlock	unlock
gunlocks	unlocks
gunman	unman
guns	uns
gunship	unship
gunships	unships
gunslinging	unslinging
gurge	urge
gurged	urged
gurges	urges
gurging	urging
gurus	urus
gusher	usher
gushers	ushers
gut	ut
guts	uts
gutter	utter
guttered	uttered
guttering	uttering
gutters	utters
hackee	ackee
hackees	ackees
had	ad
hae	ae
haft	aft
hafter	after
hafters	afters
hag	ag
haggadic	aggadic
hah	ah
haha	aha
hahs	ahs
hail	ail
hailed	ailed
hailing	ailing
hails	ails
hair	air
hairbrush	airbrush
hairbrushes	airbrushes
haired	aired
hairier	airier
hairiest	airiest
hairiness	airiness
hairinesses	airinesses
hairless	airless
hairlessness	airlessness
hairlessnesses	airlessnesses
hairlike	airlike
hairline	airline
hairlines	airlines
hairs	airs
hairy	airy
halation	alation
halations	alations
hale	ale
hales	ales
hall	all
hallot	allot
hallow	allow
hallowed	allowed
hallowing	allowing
hallows	allows
halls	alls
halma	alma
halmas	almas
halms	alms
haloes	aloes
halt	alt
halter	alter
haltered	altered
haltering	altering
halters	alters
halts	alts
ham	am
hambones	ambones
hand	and
hands	ands
hanger	anger
hangers	angers
hansa	ansa
hant	ant
hanted	anted
hanting	anting
hants	ants
haplite	aplite
haplites	aplites
harbor	arbor
harbored	arbored
harbors	arbors
harbour	arbour
harboured	arboured
harbours	arbours
hare	are
hares	ares
hark	ark
harks	arks
harm	arm
harmed	armed
harmer	armer
harmers	armers
harmful	armful
harming	arming
harmless	armless
harmonica	armonica
harmonicas	armonicas
harms	arms
harquebus	arquebus
harquebuses	arquebuses
harrow	arrow
harrowed	arrowed
harrowing	arrowing
harrows	arrows
hart	art
hartal	artal
harts	arts
haruspex	aruspex
haruspices	aruspices
has	as
hash	ash
hashed	ashed
hashes	ashes
hashing	ashing
hasp	asp
hasps	asps
hat	at
hate	ate
hates	ates
haunt	aunt
haunts	aunts
hauteur	auteur
hauteurs	auteurs
have	ave
havens	avens
haver	aver
havers	avers
haves	aves
haw	aw
hawed	awed
hawing	awing
hay	ay
hays	ays
hazan	azan
hazans	azans
hear	ear
hearing	earing
hearings	earings
hears	ears
hearth	earth
hearths	earths
heat	eat
heatable	eatable
heater	eater
heaters	eaters
heath	eath
heating	eating
heats	eats
heave	eave
heaved	eaved
heaves	eaves
hedge	edge
hedged	edged
hedger	edger
hedgers	edgers
hedges	edges
hedgier	edgier
hedgiest	edgiest
hedging	edging
hedgy	edgy
heel	eel
heels	eels
heft	eft
hefts	efts
heh	eh
height	eight
heighth	eighth
heighths	eighths
heights	eights
held	eld
hell	ell
hells	ells
helm	elm
helms	elms
helves	elves
hem	em
heme	eme
hemes	emes
hemic	emic
hemmer	emmer
hemmers	emmers
hems	ems
hen	en
hens	ens
her	er
here	ere
hern	ern
herns	erns
heros	eros
herring	erring
hers	ers
hes	es
hessonite	essonite
hessonites	essonites
het	et
heth	eth
heths	eths
hewer	ewer
hewers	ewers
hex	ex
hexamine	examine
hexamines	examines
hexarchies	exarchies
hexarchy	exarchy
hexes	exes
hexing	exing
hick	ick
hid	id
hides	ides
hill	ill
hiller	iller
hills	ills
hilly	illy
hin	in
hinkier	inkier
hinkiest	inkiest
hinky	inky
hins	ins
hinter	inter
hinters	inters
hire	ire
hired	ired
hires	ires
hiring	iring
his	is
hit	it
hitch	itch
hitched	itched
hitches	itches
hitching	itching
hither	ither
hits	its
hmm	mm
hoar	oar
hoars	oars
hoboes	oboes
hocker	ocker
hockers	ockers
hod	od
hods	ods
hoe	oe
hoes	oes
hoke	oke
hokes	okes
hold	old
holden	olden
holder	older
holds	olds
hole	ole
holes	oles
holla	olla
hollas	ollas
hombre	ombre
hombres	ombres
homer	omer
homers	omers
hon	on
hone	one
hones	ones
hons	ons
hoops	oops
hoot	oot
hoots	oots
hop	op
hope	ope
hoped	oped
hopes	opes
hoping	oping
hops	ops
hora	ora
horal	oral
horologies	orologies
horology	orology
hose	ose
hoses	oses
hosier	osier
hosiers	osiers
hostler	ostler
hostlers	ostlers
hotter	otter
hour	our
hours	ours
housel	ousel
housels	ousels
hover	over
hovered	overed
hovering	overing
hovers	overs
how	ow
howe	owe
howes	owes
howl	owl
howlet	owlet
howlets	owlets
howls	owls
hoy	oy
huh	uh
hum	um
humbles	umbles
hump	ump
humped	umped
humping	umping
humps	umps
hun	un
huns	uns
hup	up
hurds	urds
hut	ut
huts	uts
hwan	wan
ibices	bices
ibis	bis
ibises	bises
icon	con
icones	cones
iconic	conic
iconical	conical
iconically	conically
iconicities	conicities
iconicity	conicity
icons	cons
ideal	deal
ideals	deals
idol	dol
idols	dols
ikat	kat
ikats	kats
ilea	lea
ileal	leal
ilex	lex
ilexes	lexes
image	mage
images	mages
imid	mid
imids	mids
imine	mine
imines	mines
inerts	nerts
iodic	odic
ion	on
ionium	onium
ions	ons
irate	rate
irater	rater
ire	re
ired	red
ires	res
irid	rid
irides	rides
irids	rids
iring	ring
irises	rises
irising	rising
isatin	satin
isatins	satins
islander	slander
islanders	slanders
isled	sled
isling	sling
isolate	solate
isolated	solated
isolates	solates
isolating	solating
isolation	solation
isolations	solations
ivied	vied
ivies	vies
iwis	wis
jab	ab
jabs	abs
jag	ag
jager	ager
jagers	agers
jagger	agger
jaggers	aggers
jail	ail
jailed	ailed
jailing	ailing
jails	ails
jam	am
jane	ane
janes	anes
jangle	angle
jangled	angled
jangler	angler
janglers	anglers
jangles	angles
jangling	angling
jape	ape
japed	aped
japer	aper
japeries	aperies
japers	apers
japery	apery
japes	apes
japing	aping
jar	ar
jargon	argon
jargons	argons
jars	ars
jasper	asper
jaspers	aspers
jauk	auk
jauks	auks
jaunt	aunt
jaunts	aunts
jaunty	aunty
java	ava
jaw	aw
jawed	awed
jawing	awing
jay	ay
jays	ays
jell	ell
jells	ells
jemmy	emmy
jeon	eon
jess	ess
jesses	esses
jester	ester
jesters	esters
jet	et
jiff	iff
jiffy	iffy
jigged	igged
jigging	igging
jill	ill
jills	ills
jimmies	immies
jimmy	immy
jimp	imp
jimply	imply
jin	in
jingle	ingle
jingles	ingles
jink	ink
jinked	inked
jinker	inker
jinkers	inkers
jinking	inking
jinks	inks
jinn	inn
jinns	inns
jins	ins
jism	ism
jisms	isms
jivy	ivy
jnana	nana
jnanas	nanas
jocular	ocular
jocularly	ocularly
joe	oe
joes	oes
joke	oke
jokes	okes
jole	ole
joles	oles
jones	ones
jostler	ostler
jostlers	ostlers
jotter	otter
jotters	otters
jounce	ounce
jounces	ounces
joust	oust
jousted	ousted
jouster	ouster
jousters	ousters
jousting	ousting
jousts	ousts
jow	ow
jowed	owed
jowing	owing
jowl	owl
jowls	owls
joy	oy
judder	udder
judders	udders
judo	udo
judos	udos
juke	uke
jukes	ukes
jumbles	umbles
jumbo	umbo
jumbos	umbos
jump	ump
jumped	umped
jumping	umping
jumps	umps
jun	un
junco	unco
juncos	uncos
junction	unction
junctions	unctions
junto	unto
jupon	upon
jus	us
jut	ut
jute	ute
jutes	utes
juts	uts
kaas	aas
kab	ab
kabaka	abaka
kabakas	abakas
kabs	abs
kae	ae
kail	ail
kails	ails
kain	ain
kains	ains
kale	ale
kales	ales
kalewife	alewife
kalewives	alewives
kalif	alif
kalifs	alifs
kalong	along
kami	ami
kana	ana
kanas	anas
kane	ane
kanes	anes
kart	art
karts	arts
kas	as
kat	at
kauris	auris
kava	ava
kay	ay
kays	ays
kbar	bar
kbars	bars
ked	ed
kedge	edge
kedged	edged
kedges	edges
kedging	edging
keek	eek
keel	eel
keels	eels
kef	ef
kefs	efs
kegger	egger
keggers	eggers
ken	en
kenosis	enosis
kenosises	enosises
kens	ens
kern	ern
kerne	erne
kernes	ernes
kerns	erns
ketch	etch
ketches	etches
kevil	evil
kevils	evils
kex	ex
kexes	exes
keyed	eyed
keying	eying
khat	hat
khats	hats
khet	het
kheth	heth
kheths	heths
khets	hets
khi	hi
khis	his
kick	ick
kicker	icker
kickers	ickers
kickier	ickier
kickiest	ickiest
kicky	icky
kid	id
kids	ids
kif	if
kifs	ifs
kill	ill
killer	iller
kills	ills
kin	in
kink	ink
kinked	inked
kinkier	inkier
kinkiest	inkiest
kinkiness	inkiness
kinkinesses	inkinesses
kinking	inking
kinks	inks
kinky	inky
kins	ins
kirk	irk
kirks	irks
kit	it
kiter	iter
kits	its
kiwis	iwis
klatch	latch
klatches	latches
klister	lister
klisters	listers
klong	long
klongs	longs
kloof	loof
kloofs	loofs
kluge	luge
kluges	luges
klutz	lutz
klutzes	lutzes
knap	nap
knapped	napped
knapper	napper
knappers	nappers
knapping	napping
knaps	naps
knave	nave
knaves	naves
knee	nee
kneed	need
knew	new
knickers	nickers
knight	night
knightly	nightly
knights	nights
knit	nit
knits	nits
knob	nob
knobbier	nobbier
knobbiest	nobbiest
knobby	nobby
knobs	nobs
knock	nock
knocked	nocked
knocking	nocking
knocks	nocks
knot	not
know	now
knows	nows
knubbier	nubbier
knubbiest	nubbiest
knubby	nubby
knurl	nurl
knurled	nurled
knurling	nurling
knurls	nurls
koi	oi
kop	op
kops	ops
kor	or
kora	ora
kore	ore
kors	ors
kos	os
kraft	raft
krafts	rafts
krater	rater
kraters	raters
krill	rill
krills	rills
krimmer	rimmer
krimmers	rimmers
krises	rises
kudo	udo
kudos	udos
kurus	urus
kvas	vas
kvases	vases
kvetch	vetch
kvetches	vetches
kyack	yack
kyacks	yacks
kyak	yak
kyaks	yaks
kyar	yar
kye	ye
kyes	yes
lab	ab
labilities	abilities
lability	ability
labs	abs
lace	ace
laced	aced
lacerate	acerate
lacerated	acerated
laces	aces
laches	aches
lacing	acing
lad	ad
ladder	adder
ladders	adders
lads	ads
lag	ag
lager	ager
lagers	agers
lagger	agger
laggers	aggers
laid	aid
lain	ain
lair	air
laired	aired
lairing	airing
lairs	airs
lall	all
lalls	alls
lam	am
lama	ama
lamas	amas
lamber	amber
lambers	ambers
lament	ament
laments	aments
lamia	amia
lamias	amias
lamp	amp
lamps	amps
land	and
lands	ands
lane	ane
lanes	anes
languish	anguish
languished	anguished
languishes	anguishes
languishing	anguishing
lapse	apse
lapses	apses
lar	ar
larch	arch
larches	arches
lares	ares
lark	ark
larks	arks
lars	ars
larum	arum
larums	arums
larval	arval
las	as
lash	ash
lashed	ashed
lashes	ashes
lashing	ashing
lass	ass
lasses	asses
laster	aster
lasters	asters
lat	at
late	ate
latria	atria
lauding	auding
laura	aura
laurae	aurae
lauras	auras
laureate	aureate
lava	ava
lave	ave
laver	aver
lavers	avers
laves	aves
law	aw
lawed	awed
lawful	awful
lawfully	awfully
lawfulness	awfulness
lawfulnesses	awfulnesses
lawing	awing
lawless	awless
lawn	awn
lawns	awns
lawny	awny
lax	ax
lay	ay
lays	ays
lazurite	azurite
lazurites	azurites
leach	each
lear	ear
learn	earn
learned	earned
learner	earner
learners	earners
learning	earning
learnings	earnings
learns	earns
lears	ears
lease	ease
leased	eased
leases	eases
leasing	easing
least	east
leasts	easts
leave	eave
leaved	eaved
leaves	eaves
leched	eched
leches	eches
leching	eching
led	ed
ledge	edge
ledger	edger
ledgers	edgers
ledges	edges
ledgier	edgier
ledgiest	edgiest
ledgy	edgy
leek	eek
leerier	eerier
leeriest	eeriest
leerily	eerily
leery	eery
left	eft
lefts	efts
legal	egal
leger	eger
legers	egers
legged	egged
legging	egging
leggy	eggy
leke	eke
lend	end
lender	ender
lenders	enders
lending	ending
lends	ends
lens	ens
lepidote	epidote
lepidotes	epidotes
less	ess
let	et
letch	etch
letched	etched
letches	etches
letching	etching
lever	ever
lex	ex
lexes	exes
lice	ice
lich	ich
lick	ick
licker	icker
lickers	ickers
lid	id
lids	ids
ligneous	igneous
lignified	ignified
lignifies	ignifies
lignify	ignify
lignifying	ignifying
lignite	ignite
lignites	ignites
limbed	imbed
limitable	imitable
limitation	imitation
limitations	imitations
limitative	imitative
limp	imp
limped	imped
limping	imping
limply	imply
limps	imps
lin	in
lindies	indies
link	ink
linked	inked
linker	inker
linkers	inkers
linking	inking
links	inks
linky	inky
linn	inn
linns	inns
lins	ins
linter	inter
linters	inters
lion	ion
lionise	ionise
lionised	ionised
lionises	ionises
lionising	ionising
lionization	ionization
lionizations	ionizations
lionize	ionize
lionized	ionized
lionizer	ionizer
lionizers	ionizers
lionizes	ionizes
lionizing	ionizing
lions	ions
lire	ire
lis	is
lisle	isle
lisles	isles
lit	it
liter	iter
literate	iterate
literates	iterates
literation	iteration
literations	iterations
lither	ither
lits	its
llama	lama
llamas	lamas
loaf	oaf
loafs	oafs
loath	oath
loaves	oaves
lobe	obe
lobelia	obelia
lobelias	obelias
lobes	obes
loca	oca
locker	ocker
lockers	ockers
locular	ocular
loculi	oculi
loculus	oculus
lode	ode
lodes	odes
loft	oft
lofter	ofter
lomenta	omenta
lomentum	omentum
lomentums	omentums
lone	one
loneness	oneness
lonenesses	onenesses
loops	oops
loot	oot
loots	oots
lop	op
lope	ope
loped	oped
lopes	opes
loping	oping
lops	ops
loral	oral
lore	ore
lores	ores
lose	ose
loses	oses
lotic	otic
lotto	otto
lottos	ottos
loud	oud
lour	our
lours	ours
lout	out
louted	outed
louting	outing
louts	outs
lover	over
loverly	overly
lovers	overs
low	ow
lowe	owe
lowed	owed
lowes	owes
lowing	owing
lown	own
lowse	owse
lox	ox
loxes	oxes
lulu	ulu
lulus	ulus
lum	um
lumber	umber
lumbered	umbered
lumbering	umbering
lumbers	umbers
lump	ump
lumped	umped
lumping	umping
lumps	umps
lusher	usher
lute	ute
lutes	utes
lyard	yard
lye	ye
lyes	yes
mace	ace
maced	aced
macerate	acerate
macerated	acerated
maces	aces
mache	ache
maches	aches
macing	acing
mad	ad
madded	added
madder	adder
madders	adders
madding	adding
madman	adman
madmen	admen
mads	ads
mae	ae
mag	ag
mage	age
mages	ages
magma	agma
magmas	agmas
magnate	agnate
magnates	agnates
maid	aid
maids	aids
mail	ail
mailed	ailed
mailing	ailing
mails	ails
maim	aim
maimed	aimed
maimer	aimer
maimers	aimers
maiming	aiming
maims	aims
main	ain
mains	ains
mair	air
mairs	airs
malar	alar
malate	alate
malates	alates
male	ale
males	ales
malign	align
maligned	aligned
maligner	aligner
maligners	aligners
maligning	aligning
maligns	aligns
maline	aline
malines	alines
mall	all
mallee	allee
mallees	allees
mallow	allow
mallows	allows
malls	alls
malms	alms
malt	alt
malts	alts
mama	ama
mamas	amas
mambo	ambo
mambos	ambos
mamie	amie
mamies	amies
man	an
mana	ana
manas	anas
mane	ane
manes	anes
mangel	angel
mangels	angels
manger	anger
mangers	angers
mangle	angle
mangled	angled
mangler	angler
manglers	anglers
mangles	angles
mangling	angling
manna	anna
mannas	annas
manta	anta
mantas	antas
mantes	antes
mantic	antic
mantis	antis
mantra	antra
manus	anus
many	any
mar	ar
marc	arc
march	arch
marched	arched
marcher	archer
marchers	archers
marches	arches
marching	arching
marcs	arcs
mare	are
mares	ares
margent	argent
margents	argents
maria	aria
mark	ark
marks	arks
marrow	arrow
marrowed	arrowed
marrowing	arrowing
marrows	arrows
marrowy	arrowy
mars	ars
marse	arse
marses	arses
mart	art
marts	arts
mas	as
mascot	ascot
mascots	ascots
mash	ash
mashed	ashed
mashes	ashes
mashing	ashing
mashy	ashy
mask	ask
masked	asked
masker	asker
maskers	askers
masking	asking
maskings	askings
masks	asks
mass	ass
masses	asses
master	aster
masters	asters
mat	at
mate	ate
mates	ates
matt	att
mauger	auger
mavens	avens
maw	aw
mawed	awed
mawing	awing
mawn	awn
max	ax
maxed	axed
maxes	axes
maxilla	axilla
maxillae	axillae
maxillaries	axillaries
maxillary	axillary
maxillas	axillas
maxis	axis
may	ay
mays	ays
meager	eager
meagerly	eagerly
meagerness	eagerness
meagernesses	eagernesses
meagre	eagre
meat	eat
meats	eats
med	ed
meek	eek
mel	el
meld	eld
melder	elder
melders	elders
melds	elds
mell	ell
mells	ells
mels	els
mem	em
member	ember
members	embers
meme	eme
mems	ems
men	en
mend	end
mended	ended
mender	ender
menders	enders
mending	ending
mendings	endings
mends	ends
menologies	enologies
menology	enology
mere	ere
meristic	eristic
meristically	eristically
mesne	esne
mess	ess
messes	esses
met	et
meta	eta
meth	eth
methane	ethane
methanes	ethanes
methanol	ethanol
methanols	ethanols
methionine	ethionine
methionines	ethionines
methoxy	ethoxy
methoxyl	ethoxyl
meths	eths
methyl	ethyl
methylate	ethylate
methylated	ethylated
methylates	ethylates
methylating	ethylating
methylene	ethylene
methylenes	ethylenes
methylic	ethylic
methyls	ethyls
mho	ho
mice	ice
mick	ick
mid	id
mids	ids
miff	iff
miffier	iffier
miffiest	iffiest
miffy	iffy
migg	igg
miggs	iggs
milia	ilia
milium	ilium
milk	ilk
milks	ilks
mill	ill
miller	iller
mills	ills
mingle	ingle
mingles	ingles
minion	inion
mink	ink
minks	inks
minter	inter
minters	inters
mire	ire
mired	ired
mires	ires
mirid	irid
mirids	irids
miring	iring
mirk	irk
mirks	irks
mis	is
misled	isled
misogamies	isogamies
misogamy	isogamy
miter	iter
mither	ither
moat	oat
moatlike	oatlike
moats	oats
mocker	ocker
mockers	ockers
mod	od
mode	ode
modes	odes
mods	ods
moil	oil
moiled	oiled
moiler	oiler
moilers	oilers
moiling	oiling
moils	oils
moke	oke
mokes	okes
mold	old
molder	older
molds	olds
moldy	oldy
mole	ole
moles	oles
mom	om
momenta	omenta
momentum	omentum
momentums	omentums
moms	oms
mon	on
mono	ono
monos	onos
mons	ons
moot	oot
moots	oots
mop	op
mope	ope
moped	oped
mopes	opes
moping	oping
mops	ops
mor	or
mora	ora
moral	oral
moralism	oralism
moralisms	oralisms
moralist	oralist
moralists	oralists
moralities	oralities
morality	orality
morally	orally
morals	orals
moratory	oratory
more	ore
mores	ores
morgan	organ
morgans	organs
morphic	orphic
morris	orris
morrises	orrises
mors	ors
mort	ort
morts	orts
mos	os
mother	other
mothers	others
motto	otto
mottos	ottos
mouch	ouch
mouched	ouched
mouches	ouches
mouching	ouching
mover	over
movers	overs
mow	ow
mowed	owed
mowing	owing
mown	own
mudder	udder
mudders	udders
mum	um
mumbles	umbles
mumm	umm
mump	ump
mumped	umped
mumping	umping
mumps	umps
mun	un
muns	uns
murine	urine
murines	urines
mus	us
muse	use
mused	used
museful	useful
muser	user
musers	users
muses	uses
musher	usher
mushers	ushers
musing	using
mut	ut
mute	ute
mutes	utes
muts	uts
mutter	utter
muttered	uttered
mutterer	utterer
mutterers	utterers
muttering	uttering
mutters	utters
nab	ab
nabs	abs
naches	aches
nacre	acre
nacred	acred
nacres	acres
nae	ae
nag	ag
nagger	agger
naggers	aggers
nah	ah
nail	ail
nailed	ailed
nailing	ailing
nails	ails
naiver	aiver
nam	am
nan	an
nana	ana
nanas	anas
nape	ape
naperies	aperies
napery	apery
napes	apes
naphtha	aphtha
narc	arc
narco	arco
narcs	arcs
nares	ares
nark	ark
narks	arks
narrow	arrow
narrowed	arrowed
narrowing	arrowing
narrows	arrows
nascent	ascent
nates	ates
natrium	atrium
natriums	atriums
naught	aught
naughts	aughts
nave	ave
naves	aves
navicular	avicular
navigator	avigator
navigators	avigators
naw	aw
nay	ay
nays	ays
near	ear
neared	eared
nearing	earing
nearlier	earlier
nearliest	earliest
nearly	early
nears	ears
neat	eat
neaten	eaten
neater	eater
neath	eath
neats	eats
neither	either
nemeses	emeses
nemesis	emesis
neolith	eolith
neolithic	eolithic
neoliths	eoliths
neon	eon
neons	eons
ness	ess
nesses	esses
nester	ester
nesters	esters
net	et
nether	ether
neve	eve
never	ever
nevermore	evermore
neves	eves
newer	ewer
nice	ice
nick	ick
nicker	icker
nickers	ickers
nides	ides
nill	ill
nills	ills
nit	it
niter	iter
nits	its
nod	od
nodder	odder
node	ode
nodes	odes
nods	ods
noes	oes
noh	oh
noil	oil
noils	oils
noily	oily
nom	om
nomen	omen
noms	oms
nonce	once
none	one
nones	ones
nonuses	onuses
noodles	oodles
noosphere	oosphere
noospheres	oospheres
nopal	opal
nopals	opals
nope	ope
nor	or
nos	os
nose	ose
noses	oses
nosier	osier
nother	other
nought	ought
noughts	oughts
nova	ova
novation	ovation
novations	ovations
now	ow
nuke	uke
nukes	ukes
number	umber
numbered	umbered
numbering	umbering
numbers	umbers
numbles	umbles
nun	un
nuncle	uncle
nuncles	uncles
nunlike	unlike
nuns	uns
nurd	urd
nurds	urds
nus	us
nut	ut
nuts	uts
nutter	utter
nutters	utters
oar	ar
oars	ars
oat	at
oaves	aves
oba	ba
obas	bas
obe	be
obey	bey
obeys	beys
obi	bi
obias	bias
obis	bis
obit	bit
obits	bits
oblast	blast
oblasts	blasts
oblate	blate
obole	bole
oboles	boles
obolus	bolus
ocarina	carina
ocarinas	carinas
ocellar	cellar
ocelli	celli
ocreate	create
oda	da
odah	dah
odahs	dahs
ode	de
odonate	donate
odonates	donates
odor	dor
odors	dors
odour	dour
oecologies	ecologies
oecology	ecology
oecumenical	ecumenical
oedema	edema
oedemas	edemas
oedemata	edemata
oenologies	enologies
oenology	enology
oes	es
oesophagi	esophagi
oesophagus	esophagus
oestrin	estrin
oestrins	estrins
oestriol	estriol
oestriols	estriols
oestrone	estrone
oestrones	estrones
oestrous	estrous
oestrum	estrum
oestrums	estrums
oestrus	estrus
oestruses	estruses
ofay	fay
ofays	fays
ogam	gam
ogams	gams
ogee	gee
ogees	gees
ogive	give
ogives	gives
ogled	gled
ohm	hm
oho	ho
oink	ink
oinked	inked
oinking	inking
oinks	inks
oka	ka
okas	kas
okay	kay
okays	kays
olea	lea
olive	live
olives	lives
ology	logy
omega	mega
omen	men
omenta	menta
omental	mental
omentum	mentum
omicron	micron
omicrons	microns
omikron	mikron
omikrons	mikrons
omission	mission
omissions	missions
omissive	missive
onanism	nanism
onanisms	nanisms
one	ne
ono	no
onos	nos
onus	nus
ooh	oh
oohed	ohed
oohing	ohing
oohs	ohs
oologies	ologies
oologist	ologist
oologists	ologists
oology	ology
oops	ops
opacified	pacified
opacifies	pacifies
opacify	pacify
opacifying	pacifying
opah	pah
opal	pal
opals	pals
ope	pe
oped	ped
open	pen
opens	pens
opes	pes
opine	pine
opined	pined
opines	pines
oping	ping
opining	pining
opinion	pinion
opinioned	pinioned
opinions	pinions
opossum	possum
opossums	possums
opus	pus
opuses	puses
orad	rad
orally	rally
orang	rang
orange	range
oranges	ranges
orangier	rangier
orangiest	rangiest
orangy	rangy
orate	rate
orated	rated
orates	rates
orating	rating
oration	ration
orations	rations
ore	re
oread	read
oreads	reads
ores	res
oriel	riel
oriels	riels
orotund	rotund
orotundities	rotundities
orotundity	rotundity
osteal	steal
otic	tic
otitis	titis
ourari	urari
ouraris	uraris
out	ut
outmost	utmost
outs	uts
ovaries	varies
ovariole	variole
ovarioles	varioles
ovary	vary
overbid	verbid
overbids	verbids
overset	verset
oversets	versets
overt	vert
ovine	vine
ovines	vines
ovoid	void
ovoids	voids
owe	we
owed	wed
owing	wing
oyes	yes
oyesses	yesses
ozonate	zonate
ozonated	zonated
ozonation	zonation
ozonations	zonations
ozone	zone
ozones	zones
pace	ace
paced	aced
paces	aces
pacing	acing
pact	act
paction	action
pactions	actions
pacts	acts
pad	ad
padded	added
padder	adder
padders	adders
padding	adding
paddle	addle
paddled	addled
paddles	addles
paddling	addling
pads	ads
paeon	aeon
paeons	aeons
page	age
paged	aged
pager	ager
pagers	agers
pages	ages
paging	aging
pagings	agings
pah	ah
paid	aid
pail	ail
pails	ails
pain	ain
pains	ains
pair	air
paired	aired
pairing	airing
pairings	airings
pairs	airs
pal	al
palate	alate
palates	alates
pale	ale
pales	ales
palimonies	alimonies
palimony	alimony
pall	all
pallium	allium
palliums	alliums
palls	alls
pally	ally
palms	alms
palp	alp
palps	alps
pals	als
palter	alter
paltered	altered
palterer	alterer
palterers	alterers
paltering	altering
palters	alters
pam	am
pan	an
pane	ane
paneled	aneled
paneling	aneling
panes	anes
panga	anga
pangas	angas
pant	ant
panted	anted
panther	anther
panthers	anthers
panting	anting
pants	ants
paper	aper
papers	apers
papery	apery
pappose	appose
par	ar
parable	arable
parables	arables
parch	arch
parched	arched
parches	arches
parching	arching
pare	are
pares	ares
parises	arises
park	ark
parks	arks
parles	arles
pars	ars
parse	arse
parses	arses
parson	arson
parsons	arsons
part	art
particle	article
particles	articles
particular	articular
particulate	articulate
particulates	articulates
partier	artier
partisan	artisan
partisans	artisans
partisanship	artisanship
partisanships	artisanships
parts	arts
party	arty
parvo	arvo
parvos	arvos
pas	as
pash	ash
pashed	ashed
pashes	ashes
pashing	ashing
pass	ass
passes	asses
paster	aster
pastern	astern
pasters	asters
pat	at
pate	ate
pates	ates
pave	ave
paver	aver
pavers	avers
paves	aves
pavid	avid
paw	aw
pawed	awed
pawing	awing
pawl	awl
pawls	awls
pawn	awn
pawned	awned
pawning	awning
pawns	awns
pax	ax
paxes	axes
pay	ay
pays	ays
peach	each
pear	ear
pearl	earl
pearlier	earlier
pearliest	earliest
pearls	earls
pearly	early
pears	ears
pease	ease
peases	eases
peat	eat
peats	eats
peched	eched
peching	eching
pectases	ectases
ped	ed
peek	eek
peel	eel
peels	eels
peerie	eerie
peery	eery
pegged	egged
pegging	egging
peh	eh
peke	eke
pekes	ekes
pelf	elf
pelite	elite
pelites	elites
pelves	elves
pen	en
penates	enates
penchant	enchant
penchants	enchants
pend	end
pended	ended
pending	ending
pends	ends
penological	enological
penologies	enologies
penologist	enologist
penologists	enologists
penology	enology
pens	ens
pensile	ensile
pentangle	entangle
pentangles	entangles
peon	eon
peonism	eonism
peonisms	eonisms
peons	eons
pepos	epos
per	er
pere	ere
perses	erses
pes	es
pester	ester
pesters	esters
pet	et
petiolate	etiolate
phat	hat
phew	hew
phi	hi
phis	his
phon	hon
phone	hone
phoned	honed
phones	hones
phoney	honey
phoneyed	honeyed
phoneying	honeying
phoneys	honeys
phonied	honied
phoning	honing
phons	hons
phooey	hooey
phot	hot
phots	hots
phut	hut
phuts	huts
phyla	hyla
pice	ice
pick	ick
picker	icker
pickers	ickers
pickier	ickier
pickiest	ickiest
picky	icky
pigged	igged
pigging	igging
pilea	ilea
pileum	ileum
pileus	ileus
pill	ill
pills	ills
pimp	imp
pimped	imped
pimping	imping
pimply	imply
pimps	imps
pin	in
pinch	inch
pinched	inched
pinches	inches
pinching	inching
pinfold	infold
pinfolded	infolded
pinfolding	infolding
pinfolds	infolds
pinion	inion
pink	ink
pinked	inked
pinker	inker
pinkers	inkers
pinking	inking
pinks	inks
pinky	inky
pinnate	innate
pinnately	innately
pinned	inned
pinner	inner
pinners	inners
pinning	inning
pins	ins
pinsetter	insetter
pinsetters	insetters
pinto	into
pion	ion
pionic	ionic
pions	ions
pirate	irate
pis	is
pit	it
pitch	itch
pitched	itched
pitches	itches
pitchier	itchier
pitchiest	itchiest
pitchily	itchily
pitching	itching
pitchy	itchy
pits	its
place	lace
placed	laced
placeless	laceless
placer	lacer
placers	lacers
places	laces
placing	lacing
plack	lack
placks	lacks
plaid	laid
plain	lain
planate	lanate
plane	lane
planes	lanes
plank	lank
planner	lanner
planners	lanners
plash	lash
plashed	lashed
plasher	lasher
plashers	lashers
plashes	lashes
plashing	lashing
plaster	laster
plasters	lasters
plat	lat
plate	late
plated	lated
platen	laten
platens	latens
plater	later
platina	latina
platinas	latinas
platinize	latinize
platinized	latinized
platinizes	latinizes
platinizing	latinizing
platitude	latitude
platitudes	latitudes
platitudinal	latitudinal
platitudinarian	latitudinarian
platitudinarians	latitudinarians
plats	lats
platter	latter
play	lay
played	layed
player	layer
players	layers
playing	laying
playoff	layoff
playoffs	layoffs
plays	lays
plea	lea
pleach	leach
pleached	leached
pleaches	leaches
pleaching	leaching
plead	lead
pleaded	leaded
pleader	leader
pleaders	leaders
pleading	leading
pleadings	leadings
pleads	leads
pleas	leas
please	lease
pleased	leased
pleaser	leaser
pleasers	leasers
pleases	leases
pleasing	leasing
pled	led
pledge	ledge
pledger	ledger
pledgers	ledgers
pledges	ledges
plessor	lessor
plessors	lessors
plex	lex
pliabilities	liabilities
pliability	liability
pliable	liable
plie	lie
plied	lied
plier	lier
pliers	liers
plies	lies
plight	light
plighted	lighted
plighter	lighter
plighters	lighters
plighting	lighting
plights	lights
plink	link
plinked	linked
plinker	linker
plinkers	linkers
plinking	linking
plinks	links
plop	lop
plopped	lopped
plopping	lopping
plops	lops
plot	lot
plots	lots
plotted	lotted
plotting	lotting
plough	lough
ploughs	loughs
plover	lover
plovers	lovers
plow	low
plowboy	lowboy
plowboys	lowboys
plowed	lowed
plower	lower
plowers	lowers
plowing	lowing
plowland	lowland
plowlands	lowlands
plows	lows
pluck	luck
plucked	lucked
pluckier	luckier
pluckiest	luckiest
pluckily	luckily
pluckiness	luckiness
pluckinesses	luckinesses
plucking	lucking
plucks	lucks
plucky	lucky
plug	lug
plugged	lugged
plugger	lugger
pluggers	luggers
plugging	lugging
plugs	lugs
plum	lum
plumbago	lumbago
plumbagos	lumbagos
plumber	lumber
plumbers	lumbers
plump	lump
plumped	lumped
plumpen	lumpen
plumpens	lumpens
plumper	lumper
plumpers	lumpers
plumping	lumping
plumpish	lumpish
plumps	lumps
plums	lums
plunge	lunge
plunged	lunged
plunger	lunger
plungers	lungers
plunges	lunges
plunging	lunging
plunk	lunk
plunker	lunker
plunkers	lunkers
plunks	lunks
plush	lush
plusher	lusher
plushes	lushes
plushest	lushest
plushly	lushly
plushness	lushness
plushnesses	lushnesses
plying	lying
plyingly	lyingly
pneumatic	neumatic
pod	od
podium	odium
podiums	odiums
pods	ods
poh	oh
poi	oi
poke	oke
pokes	okes
polder	older
pole	ole
poles	oles
polio	olio
polios	olios
pom	om
poms	oms
ponce	once
pone	one
pones	ones
pons	ons
poodles	oodles
pooh	ooh
poohed	oohed
poohing	oohing
poohs	oohs
poops	oops
poot	oot
poots	oots
pop	op
pope	ope
popes	opes
pops	ops
pore	ore
pores	ores
porgies	orgies
porgy	orgy
port	ort
ports	orts
pose	ose
poses	oses
postmark	ostmark
postmarks	ostmarks
pother	other
pothers	others
potter	otter
potters	otters
potto	otto
pottos	ottos
pouch	ouch
pouched	ouched
pouches	ouches
pouching	ouching
pounce	ounce
pounces	ounces
pour	our
pours	ours
pout	out
pouted	outed
pouter	outer
pouters	outers
pouting	outing
pouts	outs
pow	ow
pox	ox
poxes	oxes
poxy	oxy
praise	raise
praised	raised
praiser	raiser
praisers	raisers
praises	raises
praising	raising
pram	ram
prams	rams
prance	rance
prances	rances
prang	rang
pranged	ranged
pranging	ranging
prank	rank
pranked	ranked
pranking	ranking
prankish	rankish
pranks	ranks
prase	rase
prases	rases
prat	rat
prate	rate
prated	rated
prater	rater
praters	raters
prates	rates
prating	rating
prats	rats
prattle	rattle
prattled	rattled
prattler	rattler
prattlers	rattlers
prattles	rattles
prattling	rattling
prattlingly	rattlingly
praxes	raxes
pray	ray
prayed	rayed
praying	raying
prays	rays
preach	reach
preached	reached
preacher	reacher
preachers	reachers
preaches	reaches
preaching	reaching
preact	react
preacted	reacted
preacting	reacting
preacts	reacts
preadapt	readapt
preadapted	readapted
preadapting	readapting
preadapts	readapts
preadmission	readmission
preadmissions	readmissions
preadmit	readmit
preadmits	readmits
preadmitted	readmitted
preadmitting	readmitting
preadopt	readopt
preadopted	readopted
preadopting	readopting
preadopts	readopts
preallot	reallot
preallots	reallots
preallotted	reallotted
preallotting	reallotting
preapprove	reapprove
preapproved	reapproved
preapproves	reapproves
preapproving	reapproving
prearm	rearm
prearmed	rearmed
prearming	rearming
prearms	rearms
prearrange	rearrange
prearranged	rearranged
prearrangement	rearrangement
prearrangements	rearrangements
prearranges	rearranges
prearranging	rearranging
preassembled	reassembled
preassign	reassign
preassigned	reassigned
preassigning	reassigning
preassigns	reassigns
preaver	reaver
preavers	reavers
prebill	rebill
prebilled	rebilled
prebilling	rebilling
prebills	rebills
prebind	rebind
prebinding	rebinding
prebinds	rebinds
preboil	reboil
preboiled	reboiled
preboiling	reboiling
preboils	reboils
prebook	rebook
prebooked	rebooked
prebooking	rebooking
prebooks	rebooks
prebound	rebound
precast	recast
precasting	recasting
precasts	recasts
precede	recede
preceded	receded
precedes	recedes
preceding	receding
precent	recent
precept	recept
preceptive	receptive
preceptor	receptor
preceptors	receptors
precepts	recepts
precertification	recertification
precertifications	recertifications
precertified	recertified
precertifies	recertifies
precertify	recertify
precertifying	recertifying
precess	recess
precessed	recessed
precesses	recesses
precessing	recessing
precession	recession
precessional	recessional
precessions	recessions
precheck	recheck
prechecked	rechecked
prechecking	rechecking
prechecks	rechecks
precipe	recipe
precipes	recipes
precision	recision
precisions	recisions
precited	recited
preclean	reclean
precleaned	recleaned
precleaning	recleaning
precleans	recleans
preclusion	reclusion
preclusions	reclusions
preclusive	reclusive
preclusively	reclusively
precode	recode
precoded	recoded
precodes	recodes
precoding	recoding
precognition	recognition
precognitions	recognitions
precommitment	recommitment
precompute	recompute
precomputed	recomputed
precomputes	recomputes
precomputing	recomputing
preconceive	reconceive
preconceived	reconceived
preconceives	reconceives
preconceiving	reconceiving
preconception	reconception
preconceptions	reconceptions
precondition	recondition
preconditioned	reconditioned
preconditioning	reconditioning
preconditions	reconditions
preconquest	reconquest
preconstructed	reconstructed
precontact	recontact
preconviction	reconviction
preconvictions	reconvictions
precook	recook
precooked	recooked
precooking	recooking
precooks	recooks
precoup	recoup
precut	recut
precuts	recuts
precutting	recutting
predate	redate
predated	redated
predates	redates
predating	redating
predefine	redefine
predefined	redefined
predefines	redefines
predefining	redefining
predeliveries	redeliveries
predelivery	redelivery
predetermination	redetermination
predeterminations	redeterminations
predetermine	redetermine
predetermined	redetermined
predetermines	redetermines
predetermining	redetermining
predevelopment	redevelopment
predevelopments	redevelopments
predial	redial
predigest	redigest
predigested	redigested
predigesting	redigesting
predigestion	redigestion
predigestions	redigestions
predigests	redigests
prediscoveries	rediscoveries
prediscovery	rediscovery
predispose	redispose
predisposed	redisposed
predisposes	redisposes
predisposing	redisposing
predisposition	redisposition
predispositions	redispositions
predrill	redrill
predrilled	redrilled
predrilling	redrilling
predrills	redrills
pree	ree
preed	reed
preedit	reedit
preedited	reedited
preediting	reediting
preedits	reedits
preelect	reelect
preelected	reelected
preelecting	reelecting
preelection	reelection
preelections	reelections
preelects	reelects
preemergence	reemergence
preemployment	reemployment
preemployments	reemployments
preenact	reenact
preenacted	reenacted
preenacting	reenacting
preenacts	reenacts
preerect	reerect
preerected	reerected
preerecting	reerecting
preerects	reerects
prees	rees
preestablish	reestablish
preestablished	reestablished
preestablishes	reestablishes
preestablishing	reestablishing
preface	reface
prefaced	refaced
prefaces	refaces
prefacing	refacing
prefect	refect
prefects	refects
prefer	refer
preferable	referable
preference	reference
preferences	references
preferential	referential
preferentially	referentially
preferred	referred
preferrer	referrer
preferrers	referrers
preferring	referring
prefers	refers
prefight	refight
prefigure	refigure
prefigured	refigured
prefigures	refigures
prefiguring	refiguring
prefile	refile
prefiled	refiled
prefiles	refiles
prefiling	refiling
prefilled	refilled
prefinance	refinance
prefinanced	refinanced
prefinances	refinances
prefinancing	refinancing
prefire	refire
prefired	refired
prefires	refires
prefiring	refiring
prefix	refix
prefixed	refixed
prefixes	refixes
prefixing	refixing
prefocus	refocus
prefocused	refocused
prefocuses	refocuses
prefocusing	refocusing
prefocussed	refocussed
prefocusses	refocusses
prefocussing	refocussing
preform	reform
preformat	reformat
preformation	reformation
preformations	reformations
preformats	reformats
preformatted	reformatted
preformatting	reformatting
preformed	reformed
preforming	reforming
preforms	reforms
preformulate	reformulate
preformulated	reformulated
preformulates	reformulates
preformulating	reformulating
prefreeze	refreeze
prefreezes	refreezes
prefreezing	refreezing
prefroze	refroze
prefrozen	refrozen
pregnancies	regnancies
pregnancy	regnancy
pregnant	regnant
preheat	reheat
preheated	reheated
preheater	reheater
preheaters	reheaters
preheating	reheating
preheats	reheats
prehiring	rehiring
preignition	reignition
preignitions	reignitions
preimplantation	reimplantation
preincorporation	reincorporation
preincorporations	reincorporations
preinterview	reinterview
preinterviewed	reinterviewed
preinterviewing	reinterviewing
preinterviews	reinterviews
preinvasion	reinvasion
prejudge	rejudge
prejudged	rejudged
prejudges	rejudges
prejudging	rejudging
prelate	relate
prelates	relates
prelaunch	relaunch
prelives	relives
premade	remade
preman	reman
premanufacture	remanufacture
premanufactured	remanufactured
premanufactures	remanufactures
premanufacturing	remanufacturing
premarket	remarket
premarketing	remarketing
premarriage	remarriage
premarriages	remarriages
premeasure	remeasure
premeasured	remeasured
premeasures	remeasures
premeasuring	remeasuring
premeet	remeet
premigration	remigration
premise	remise
premised	remised
premises	remises
premising	remising
premiss	remiss
premix	remix
premixed	remixed
premixes	remixes
premixing	remixing
premixt	remixt
premodified	remodified
premodifies	remodifies
premodify	remodify
premodifying	remodifying
premoisten	remoisten
premoistened	remoistened
premoistening	remoistening
premoistens	remoistens
premold	remold
premolded	remolded
premolding	remolding
premolds	remolds
premorse	remorse
prename	rename
prenames	renames
prenominate	renominate
prenominated	renominated
prenominates	renominates
prenominating	renominating
prenomination	renomination
prenominations	renominations
prenotified	renotified
prenotifies	renotifies
prenotify	renotify
prenotifying	renotifying
prenumber	renumber
prenumbered	renumbered
prenumbering	renumbering
prenumbers	renumbers
preoccupation	reoccupation
preoccupations	reoccupations
preoccupied	reoccupied
preoccupies	reoccupies
preoccupy	reoccupy
preoccupying	reoccupying
preopening	reopening
preordain	reordain
preordained	reordained
preordaining	reordaining
preordains	reordains
preorder	reorder
preordered	reordered
preordering	reordering
preorders	reorders
prep	rep
prepack	repack
prepackage	repackage
prepackaged	repackaged
prepackages	repackages
prepackaging	repackaging
prepacked	repacked
prepacking	repacking
prepacks	repacks
prepaid	repaid
preparation	reparation
preparations	reparations
preparative	reparative
prepasted	repasted
prepasting	repasting
prepay	repay
prepaying	repaying
prepayment	repayment
prepayments	repayments
prepays	repays
preplace	replace
preplaced	replaced
preplaces	replaces
preplacing	replacing
preplan	replan
preplanned	replanned
preplanning	replanning
preplans	replans
preplant	replant
preplanting	replanting
preposition	reposition
prepositions	repositions
prepossess	repossess
prepossessed	repossessed
prepossesses	repossesses
prepossessing	repossessing
prepossession	repossession
prepossessions	repossessions
prepped	repped
preprice	reprice
prepriced	repriced
preprices	reprices
prepricing	repricing
preprint	reprint
preprinted	reprinted
preprinting	reprinting
preprints	reprints
preprocess	reprocess
preprocessed	reprocessed
preprocesses	reprocesses
preprocessing	reprocessing
preproduction	reproduction
preproductions	reproductions
preprogram	reprogram
preprogramed	reprogramed
preprograming	reprograming
preprogrammed	reprogrammed
preprogramming	reprogramming
preprograms	reprograms
preps	reps
prepublication	republication
prepublications	republications
prepurchase	repurchase
prepurchased	repurchased
prepurchases	repurchases
prepurchasing	repurchasing
prequalification	requalification
prequalifications	requalifications
prequalified	requalified
prequalifies	requalifies
prequalify	requalify
prequalifying	requalifying
prerecord	rerecord
prerecorded	rerecorded
prerecording	rerecording
prerecords	rerecords
preregister	reregister
preregistered	reregistered
preregistering	reregistering
preregisters	reregisters
preregistration	reregistration
preregistrations	reregistrations
prerelease	rerelease
prereleases	rereleases
prereview	rereview
presale	resale
preschedule	reschedule
prescheduled	rescheduled
preschedules	reschedules
prescheduling	rescheduling
preschool	reschool
preschools	reschools
prescind	rescind
prescinded	rescinded
prescinding	rescinding
prescinds	rescinds
prescore	rescore
prescored	rescored
prescores	rescores
prescoring	rescoring
prescreen	rescreen
prescreened	rescreened
prescreening	rescreening
prescreens	rescreens
prescript	rescript
prescripts	rescripts
preseason	reseason
preseasons	reseasons
presell	resell
preselling	reselling
presells	resells
present	resent
presented	resented
presentence	resentence
presentenced	resentenced
presentences	resentences
presentencing	resentencing
presenting	resenting
presentment	resentment
presentments	resentments
presents	resents
preservable	reservable
preservation	reservation
preservationist	reservationist
preservationists	reservationists
preservations	reservations
preserve	reserve
preserved	reserved
preserver	reserver
preservers	reservers
preserves	reserves
preservice	reservice
preserving	reserving
preset	reset
presets	resets
presetting	resetting
presettlement	resettlement
presettlements	resettlements
preshape	reshape
preshaped	reshaped
preshapes	reshapes
preshaping	reshaping
preshow	reshow
preshowed	reshowed
preshowing	reshowing
preshown	reshown
preshows	reshows
preside	reside
presided	resided
presidencies	residencies
presidency	residency
president	resident
presidential	residential
presidentially	residentially
presidents	residents
presider	resider
presiders	residers
presides	resides
presiding	residing
presift	resift
presifted	resifted
presifting	resifting
presifts	resifts
presoak	resoak
presoaked	resoaked
presoaking	resoaking
presoaks	resoaks
presold	resold
presort	resort
presorted	resorted
presorting	resorting
presorts	resorts
presplit	resplit
prest	rest
prestamp	restamp
prestamped	restamped
prestamping	restamping
prestamps	restamps
prester	rester
presters	resters
prestress	restress
prestressed	restressed
prestresses	restresses
prestressing	restressing
prestrike	restrike
prestructure	restructure
prestructured	restructured
prestructures	restructures
prestructuring	restructuring
prests	rests
presume	resume
presumed	resumed
presumer	resumer
presumers	resumers
presumes	resumes
presuming	resuming
presumption	resumption
presumptions	resumptions
pretape	retape
pretaped	retaped
pretapes	retapes
pretaping	retaping
pretaste	retaste
pretasted	retasted
pretastes	retastes
pretasting	retasting
pretax	retax
pretest	retest
pretested	retested
pretesting	retesting
pretests	retests
pretrain	retrain
pretrained	retrained
pretraining	retraining
pretrains	retrains
pretreat	retreat
pretreated	retreated
pretreating	retreating
pretreats	retreats
pretrial	retrial
pretrials	retrials
pretrim	retrim
pretrimmed	retrimmed
pretrimming	retrimming
pretrims	retrims
pretype	retype
pretyped	retyped
pretypes	retypes
pretyping	retyping
preunification	reunification
preunion	reunion
preunions	reunions
preunite	reunite
preunited	reunited
preunites	reunites
preuniting	reuniting
preview	review
previewed	reviewed
previewer	reviewer
previewers	reviewers
previewing	reviewing
previews	reviews
previse	revise
prevised	revised
previses	revises
prevising	revising
prevision	revision
previsionary	revisionary
previsions	revisions
previsor	revisor
previsors	revisors
prevue	revue
prevues	revues
prewarm	rewarm
prewarmed	rewarmed
prewarming	rewarming
prewarms	rewarms
prewash	rewash
prewashed	rewashed
prewashes	rewashes
prewashing	rewashing
prework	rework
prewrap	rewrap
prewrapped	rewrapped
prewrapping	rewrapping
prewraps	rewraps
prewriting	rewriting
prex	rex
prexes	rexes
price	rice
priced	riced
pricer	ricer
pricers	ricers
prices	rices
pricing	ricing
prick	rick
pricked	ricked
prickets	rickets
pricking	ricking
pricks	ricks
pride	ride
prides	rides
priding	riding
prig	rig
prigged	rigged
prigging	rigging
prigs	rigs
prill	rill
prilled	rilled
prilling	rilling
prills	rills
prim	rim
prime	rime
primed	rimed
primer	rimer
primers	rimers
primes	rimes
priming	riming
primmed	rimmed
primmer	rimmer
primming	rimming
prims	rims
prink	rink
prinks	rinks
prise	rise
prises	rises
prising	rising
privet	rivet
privets	rivets
proband	roband
probands	robands
probe	robe
probed	robed
probes	robes
probing	robing
prod	rod
prodded	rodded
prodding	rodding
prods	rods
prole	role
proles	roles
prom	rom
proms	roms
proof	roof
proofed	roofed
proofer	roofer
proofers	roofers
proofing	roofing
proofs	roofs
proper	roper
propers	ropers
prose	rose
prosed	rosed
proses	roses
prosier	rosier
prosiest	rosiest
prosily	rosily
prosiness	rosiness
prosinesses	rosinesses
prosing	rosing
prostrate	rostrate
prosy	rosy
prove	rove
proved	roved
proven	roven
prover	rover
provers	rovers
proves	roves
proving	roving
prow	row
prower	rower
prows	rows
prude	rude
prune	rune
prunes	runes
psalter	salter
psalters	salters
pshaw	shaw
pshawed	shawed
pshawing	shawing
pshaws	shaws
psi	si
psis	sis
ptui	tui
pugh	ugh
puke	uke
pukes	ukes
pump	ump
pumped	umped
pumping	umping
pumps	umps
pun	un
pungently	ungently
punitive	unitive
puns	uns
punties	unties
punto	unto
pup	up
pupas	upas
pupped	upped
pupping	upping
pups	ups
puranic	uranic
purge	urge
purged	urged
purger	urger
purgers	urgers
purges	urges
purging	urging
purine	urine
purines	urines
pus	us
puses	uses
pusher	usher
pushers	ushers
put	ut
puts	uts
putter	utter
puttered	uttered
putterer	utterer
putterers	utterers
puttering	uttering
putters	utters
pya	ya
pye	ye
pyes	yes
pyin	yin
pyins	yins
qaid	aid
qaids	aids
qat	at
qis	is
race	ace
raced	aced
races	aces
racing	acing
rad	ad
radded	added
radding	adding
raddle	addle
raddled	addled
raddles	addles
raddling	addling
radios	adios
rads	ads
raff	aff
raft	aft
rafter	after
rafters	afters
rag	ag
raga	aga
ragas	agas
rage	age
raged	aged
ragee	agee
rages	ages
raggies	aggies
raging	aging
rah	ah
rai	ai
raid	aid
raided	aided
raider	aider
raiders	aiders
raiding	aiding
raids	aids
rail	ail
railed	ailed
railing	ailing
rails	ails
rain	ain
rains	ains
rais	ais
rakee	akee
rakees	akees
rale	ale
rales	ales
rallied	allied
rallies	allies
rally	ally
rallying	allying
ram	am
ramble	amble
rambled	ambled
rambler	ambler
ramblers	amblers
rambles	ambles
rambling	ambling
ramen	amen
rami	ami
ramie	amie
ramies	amies
ramp	amp
ramps	amps
ramus	amus
ran	an
rand	and
rands	ands
ranger	anger
rangers	angers
rani	ani
ranis	anis
rankle	ankle
rankled	ankled
rankles	ankles
rankling	ankling
rant	ant
ranted	anted
ranting	anting
rants	ants
rape	ape
raped	aped
raper	aper
rapers	apers
rapes	apes
raphides	aphides
raphis	aphis
raping	aping
rappel	appel
rappels	appels
rapt	apt
raptly	aptly
raptness	aptness
raptnesses	aptnesses
rare	are
rares	ares
ras	as
rash	ash
rashes	ashes
rasp	asp
rasper	asper
raspers	aspers
raspish	aspish
rasps	asps
raster	aster
rasters	asters
rat	at
rate	ate
rates	ates
rave	ave
ravens	avens
raver	aver
ravers	avers
raves	aves
raw	aw
rax	ax
raxed	axed
raxes	axes
raxing	axing
ray	ay
rayah	ayah
rayahs	ayahs
rays	ays
reach	each
rear	ear
reared	eared
rearing	earing
rears	ears
reave	eave
reaved	eaved
reaves	eaves
rebook	ebook
red	ed
reduce	educe
reduced	educed
reduces	educes
reducible	educible
reducing	educing
reduction	eduction
reductions	eductions
reductive	eductive
reductor	eductor
reductors	eductors
reek	eek
reel	eel
reels	eels
ref	ef
refs	efs
reft	eft
regal	egal
regress	egress
regressed	egressed
regresses	egresses
regressing	egressing
regression	egression
regressions	egressions
regret	egret
regrets	egrets
reject	eject
rejected	ejected
rejecting	ejecting
rejection	ejection
rejections	ejections
rejective	ejective
rejector	ejector
rejectors	ejectors
rejects	ejects
relapse	elapse
relapsed	elapsed
relapses	elapses
relapsing	elapsing
relate	elate
related	elated
relatedly	elatedly
relatedness	elatedness
relatednesses	elatednesses
relater	elater
relaters	elaters
relates	elates
relating	elating
relation	elation
relations	elations
relative	elative
relatives	elatives
rem	em
remail	email
remailed	emailed
remend	emend
remended	emended
remending	emending
remends	emends
remerge	emerge
remerged	emerged
remerges	emerges
remerging	emerging
remigration	emigration
remigrations	emigrations
remission	emission
remissions	emissions
remit	emit
remits	emits
remittance	emittance
remittances	emittances
remitted	emitted
remitter	emitter
remitters	emitters
remitting	emitting
remote	emote
remoter	emoter
remotes	emotes
remotion	emotion
remotions	emotions
rems	ems
rencounter	encounter
rencountered	encountered
rencountering	encountering
rencounters	encounters
rend	end
rended	ended
render	ender
renders	enders
rending	ending
rends	ends
renounce	enounce
renounced	enounced
renounces	enounces
renouncing	enouncing
renter	enter
renters	enters
renunciate	enunciate
renunciates	enunciates
renunciation	enunciation
renunciations	enunciations
renvoi	envoi
renvois	envois
repos	epos
reposes	eposes
requites	equites
reradiate	eradiate
reradiated	eradiated
reradiates	eradiates
reradiating	eradiating
rerose	erose
res	es
restate	estate
restated	estated
restates	estates
restating	estating
rester	ester
resters	esters
ret	et
retape	etape
retapes	etapes
retch	etch
retched	etched
retches	etches
retching	etching
revaluate	evaluate
revaluated	evaluated
revaluates	evaluates
revaluating	evaluating
revaluation	evaluation
revaluations	evaluations
reversible	eversible
reversion	eversion
reversions	eversions
revert	evert
reverted	everted
reverting	everting
reverts	everts
revery	every
reviler	eviler
revocable	evocable
revocation	evocation
revocations	evocations
revoke	evoke
revoked	evoked
revoker	evoker
revokers	evokers
revokes	evokes
revoking	evoking
revolute	evolute
revolution	evolution
revolutionarily	evolutionarily
revolutionary	evolutionary
revolutionist	evolutionist
revolutionists	evolutionists
revolutions	evolutions
revolvable	evolvable
revolve	evolve
revolved	evolved
revolver	evolver
revolvers	evolvers
revolves	evolves
revolving	evolving
revulsion	evulsion
revulsions	evulsions
rex	ex
rexes	exes
rhematic	hematic
rho	ho
rice	ice
riced	iced
rices	ices
rich	ich
ricing	icing
rick	ick
rictus	ictus
rictuses	ictuses
rid	id
rides	ides
rids	ids
rif	if
riff	iff
rifs	ifs
rigged	igged
rigging	igging
rill	ill
rills	ills
rin	in
rink	ink
rinks	inks
rinning	inning
rins	ins
roar	oar
roared	oared
roaring	oaring
roars	oars
roast	oast
roasts	oasts
robe	obe
robes	obes
rocker	ocker
rockers	ockers
rod	od
rode	ode
rods	ods
roe	oe
roes	oes
roil	oil
roiled	oiled
roilier	oilier
roiliest	oiliest
roiling	oiling
roils	oils
roily	oily
role	ole
roles	oles
rom	om
roms	oms
ronion	onion
ronions	onions
root	oot
roots	oots
rope	ope
roped	oped
ropes	opes
roping	oping
rort	ort
rose	ose
roses	oses
rosier	osier
rotter	otter
rotters	otters
rouches	ouches
roust	oust
rousted	ousted
rouster	ouster
rousters	ousters
rousting	ousting
rousts	ousts
rout	out
routed	outed
router	outer
routers	outers
routing	outing
routs	outs
roven	oven
rover	over
rovers	overs
row	ow
rowed	owed
rowing	owing
royster	oyster
roystered	oystered
roystering	oystering
roysters	oysters
rudder	udder
rudders	udders
rum	um
rumbles	umbles
rump	ump
rumps	umps
run	un
runcinate	uncinate
runless	unless
runlet	unlet
runround	unround
runrounds	unrounds
runs	uns
ruralite	uralite
ruralites	uralites
rurban	urban
ruse	use
ruses	uses
rusher	usher
rushers	ushers
rut	ut
rutile	utile
ruts	uts
rya	ya
rye	ye
ryes	yes
sab	ab
sabed	abed
sable	able
sables	ables
sabs	abs
sacred	acred
sad	ad
sadder	adder
saddle	addle
saddled	addled
saddles	addles
saddling	addling
sae	ae
sag	ag
saga	aga
sagas	agas
sage	age
sager	ager
sages	ages
sagger	agger
saggers	aggers
sago	ago
said	aid
saids	aids
sail	ail
sailed	ailed
sailing	ailing
sails	ails
sain	ain
sains	ains
sal	al
salary	alary
sale	ale
sales	ales
saline	aline
salines	alines
sall	all
sallied	allied
sallies	allies
sallow	allow
sallowed	allowed
sallowing	allowing
sallows	allows
sally	ally
sallying	allying
salp	alp
salps	alps
sals	als
salt	alt
salter	alter
salters	alters
salts	alts
sambo	ambo
sambos	ambos
samp	amp
sample	ample
sampler	ampler
samps	amps
sand	and
sands	ands
sane	ane
sanes	anes
sanga	anga
sangas	angas
sanger	anger
sangers	angers
sanguine	anguine
sark	ark
sarks	arks
sash	ash
sashed	ashed
sashes	ashes
sashing	ashing
sass	ass
sasses	asses
sat	at
sate	ate
sates	ates
sauger	auger
saugers	augers
savant	avant
save	ave
saver	aver
savers	avers
saves	aves
saw	aw
sawed	awed
sawing	awing
sawn	awn
sax	ax
saxes	axes
say	ay
says	ays
scab	cab
scabbed	cabbed
scabbing	cabbing
scabby	cabby
scabs	cabs
scad	cad
scads	cads
scall	call
scalls	calls
scam	cam
scamp	camp
scamped	camped
scamper	camper
scampers	campers
scampi	campi
scamping	camping
scamps	camps
scams	cams
scan	can
scandent	candent
scanned	canned
scanner	canner
scanners	canners
scanning	canning
scannings	cannings
scans	cans
scant	cant
scanted	canted
scanter	canter
scanting	canting
scants	cants
scanty	canty
scape	cape
scaped	caped
scapes	capes
scar	car
scare	care
scared	cared
scarer	carer
scarers	carers
scares	cares
scaring	caring
scarious	carious
scarless	carless
scarp	carp
scarped	carped
scarper	carper
scarpers	carpers
scarping	carping
scarps	carps
scarrier	carrier
scarry	carry
scars	cars
scart	cart
scarted	carted
scarting	carting
scarts	carts
scarves	carves
scat	cat
scats	cats
scatted	catted
scattier	cattier
scattiest	cattiest
scatting	catting
scatty	catty
scent	cent
scents	cents
schiller	chiller
schillers	chillers
schilling	chilling
scion	cion
scions	cions
scoff	coff
scoffer	coffer
scoffers	coffers
scoffing	coffing
scoffs	coffs
scold	cold
scolder	colder
scolds	colds
scollop	collop
scollops	collops
scone	cone
scones	cones
scoop	coop
scooped	cooped
scooper	cooper
scoopers	coopers
scooping	cooping
scoops	coops
scoot	coot
scooter	cooter
scooters	cooters
scoots	coots
scop	cop
scope	cope
scoped	coped
scopes	copes
scoping	coping
scops	cops
scopula	copula
scopulae	copulae
scopulas	copulas
score	core
scored	cored
scoreless	coreless
scorer	corer
scorers	corers
scores	cores
scoria	coria
scoriaceous	coriaceous
scoring	coring
scorn	corn
scorned	corned
scorner	corner
scorners	corners
scorning	corning
scorns	corns
scot	cot
scots	cots
scouter	couter
scouters	couters
scouth	couth
scouther	couther
scouths	couths
scow	cow
scowed	cowed
scowing	cowing
scowl	cowl
scowled	cowled
scowling	cowling
scowls	cowls
scows	cows
scrag	crag
scragged	cragged
scraggier	craggier
scraggiest	craggiest
scraggy	craggy
scrags	crags
scram	cram
scrammed	crammed
scramming	cramming
scrams	crams
scrap	crap
scrape	crape
scraped	craped
scrapes	crapes
scraping	craping
scrapped	crapped
scrapper	crapper
scrappers	crappers
scrappier	crappier
scrappiest	crappiest
scrapping	crapping
scrappy	crappy
scraps	craps
scratch	cratch
scratches	cratches
scrawl	crawl
scrawled	crawled
scrawler	crawler
scrawlers	crawlers
scrawlier	crawlier
scrawliest	crawliest
scrawling	crawling
scrawls	crawls
scrawly	crawly
screak	creak
screaked	creaked
screaking	creaking
screaks	creaks
screaky	creaky
scream	cream
screamed	creamed
screamer	creamer
screamers	creamers
screaming	creaming
screams	creams
screed	creed
screeds	creeds
screw	crew
screwed	crewed
screwing	crewing
screws	crews
scribbled	cribbled
scried	cried
scries	cries
scrimp	crimp
scrimped	crimped
scrimper	crimper
scrimpers	crimpers
scrimpier	crimpier
scrimpiest	crimpiest
scrimping	crimping
scrimps	crimps
scrimpy	crimpy
scrunch	crunch
scrunched	crunched
scrunches	crunches
scrunching	crunching
scry	cry
scrying	crying
scud	cud
scuds	cuds
scuff	cuff
scuffed	cuffed
scuffing	cuffing
scuffs	cuffs
scull	cull
sculled	culled
sculler	culler
scullers	cullers
sculling	culling
scullion	cullion
scullions	cullions
sculls	culls
scummer	cummer
scummers	cummers
scunner	cunner
scunners	cunners
scup	cup
scupper	cupper
scuppers	cuppers
scups	cups
scurf	curf
scurfs	curfs
scurried	curried
scurries	curries
scurry	curry
scurrying	currying
scurvier	curvier
scurviest	curviest
scurvy	curvy
scut	cut
scutch	cutch
scutches	cutches
scute	cute
scutes	cutes
scuts	cuts
scutter	cutter
scutters	cutters
scuttle	cuttle
scuttled	cuttled
scuttles	cuttles
scuttling	cuttling
sear	ear
seared	eared
searing	earing
sears	ears
seat	eat
seater	eater
seaters	eaters
seating	eating
seatings	eatings
seats	eats
sedge	edge
sedges	edges
sedgier	edgier
sedgiest	edgiest
sedgy	edgy
sedile	edile
sedition	edition
seditions	editions
seduce	educe
seduced	educed
seduces	educes
seducing	educing
seduction	eduction
seductions	eductions
seductive	eductive
seek	eek
seel	eel
seels	eels
seely	eely
seggar	eggar
seggars	eggars
sego	ego
segos	egos
sel	el
select	elect
selectable	electable
selected	elected
selectee	electee
selectees	electees
selecting	electing
selection	election
selections	elections
selective	elective
selectively	electively
selectiveness	electiveness
selectivenesses	electivenesses
selector	elector
selectors	electors
selects	elects
self	elf
selfish	elfish
selfishly	elfishly
sell	ell
sells	ells
sels	els
selves	elves
seme	eme
semes	emes
sen	en
senate	enate
senates	enates
send	end
sended	ended
sender	ender
senders	enders
sending	ending
sends	ends
sentries	entries
sentry	entry
sepic	epic
ser	er
sera	era
sere	ere
sers	ers
set	et
seta	eta
seven	even
sevens	evens
sever	ever
sewer	ewer
sewers	ewers
sex	ex
sexes	exes
sexing	exing
sexist	exist
sexists	exists
sexploitation	exploitation
sexploitations	exploitations
sextant	extant
sforzando	forzando
sforzandos	forzandos
sgraffiti	graffiti
sgraffito	graffito
sha	ha
shack	hack
shackle	hackle
shackled	hackled
shackler	hackler
shacklers	hacklers
shackles	hackles
shackling	hackling
shacks	hacks
shad	had
shaddock	haddock
shaddocks	haddocks
shade	hade
shaded	haded
shades	hades
shading	hading
shaft	haft
shafted	hafted
shafting	hafting
shafts	hafts
shag	hag
shagged	hagged
shagging	hagging
shags	hags
shah	hah
shahs	hahs
shake	hake
shakes	hakes
shale	hale
shaled	haled
shales	hales
shall	hall
shallot	hallot
shallow	hallow
shallowed	hallowed
shallower	hallower
shallowing	hallowing
shallows	hallows
shalt	halt
sham	ham
shame	hame
shames	hames
shammed	hammed
shammer	hammer
shammers	hammers
shamming	hamming
shammy	hammy
shams	hams
shandy	handy
shank	hank
shanked	hanked
shanking	hanking
shanks	hanks
shard	hard
shards	hards
share	hare
shared	hared
shares	hares
sharing	haring
shark	hark
sharked	harked
sharking	harking
sharks	harks
sharp	harp
sharped	harped
sharper	harper
sharpers	harpers
sharpies	harpies
sharping	harping
sharps	harps
sharpy	harpy
shat	hat
shatter	hatter
shatters	hatters
shaugh	haugh
shaughs	haughs
shaul	haul
shauled	hauled
shauling	hauling
shauls	hauls
shave	have
shaven	haven
shaver	haver
shavers	havers
shaves	haves
shaving	having
shaw	haw
shawed	hawed
shawing	hawing
shaws	haws
shay	hay
shays	hays
she	he
sheal	heal
shealing	healing
sheals	heals
shear	hear
shearer	hearer
shearers	hearers
shearing	hearing
shearings	hearings
shears	hears
sheath	heath
sheather	heather
sheathers	heathers
sheaths	heaths
sheave	heave
sheaved	heaved
sheaves	heaves
sheaving	heaving
shell	hell
shelled	helled
sheller	heller
shellers	hellers
shellfire	hellfire
shellfires	hellfires
shelling	helling
shells	hells
shelve	helve
shelved	helved
shelves	helves
shelving	helving
shent	hent
sherd	herd
sherds	herds
sherries	herries
sherry	herry
shes	hes
sheuch	heuch
sheuchs	heuchs
sheugh	heugh
sheughs	heughs
shew	hew
shewed	hewed
shewer	hewer
shewers	hewers
shewing	hewing
shewn	hewn
shews	hews
shied	hied
shies	hies
shill	hill
shilled	hilled
shilling	hilling
shills	hills
shim	him
shin	hin
shinnied	hinnied
shinnies	hinnies
shinny	hinny
shinnying	hinnying
shins	hins
ship	hip
shipped	hipped
shipper	hipper
shipping	hipping
ships	hips
shire	hire
shires	hires
shist	hist
shists	hists
shit	hit
shits	hits
shitting	hitting
shive	hive
shives	hives
shock	hock
shocked	hocked
shocker	hocker
shockers	hockers
shocking	hocking
shocks	hocks
shod	hod
shodden	hodden
shoe	hoe
shoed	hoed
shoeing	hoeing
shoer	hoer
shoers	hoers
shoes	hoes
shog	hog
shogged	hogged
shogging	hogging
shogs	hogs
shone	hone
shook	hook
shooks	hooks
shoot	hoot
shooter	hooter
shooters	hooters
shooting	hooting
shoots	hoots
shop	hop
shopped	hopped
shopper	hopper
shoppers	hoppers
shopping	hopping
shoppings	hoppings
shops	hops
shorn	horn
shot	hot
shots	hots
shotted	hotted
shotting	hotting
shove	hove
shovel	hovel
shoveled	hoveled
shoveling	hoveling
shovelled	hovelled
shovelling	hovelling
shovels	hovels
shover	hover
shovers	hovers
show	how
shows	hows
shuck	huck
shucks	hucks
shun	hun
shuns	huns
shunt	hunt
shunted	hunted
shunter	hunter
shunters	hunters
shunting	hunting
shunts	hunts
shush	hush
shushed	hushed
shushes	hushes
shushing	hushing
shut	hut
shuts	huts
shutting	hutting
shying	hying
sice	ice
sices	ices
sick	ick
sicker	icker
sides	ides
sidle	idle
sidled	idled
sidler	idler
sidlers	idlers
sidles	idles
sidling	idling
signified	ignified
signifies	ignifies
signify	ignify
signifying	ignifying
signore	ignore
silex	ilex
silexes	ilexes
silk	ilk
silks	ilks
sill	ill
siller	iller
sills	ills
silly	illy
simp	imp
simply	imply
simps	imps
sin	in
single	ingle
singles	ingles
sink	ink
sinker	inker
sinkers	inkers
sinking	inking
sinks	inks
sinned	inned
sinner	inner
sinners	inners
sinning	inning
sins	ins
sinter	inter
sinters	inters
sire	ire
sired	ired
sires	ires
siring	iring
sis	is
sit	it
sits	its
sizar	izar
sizars	izars
ska	ka
skas	kas
skat	kat
skats	kats
skeen	keen
skeens	keens
skeet	keet
skeets	keets
skeg	keg
skegs	kegs
skelp	kelp
skelped	kelped
skelping	kelping
skelps	kelps
skelter	kelter
skelters	kelters
skep	kep
skeps	keps
skerries	kerries
skerry	kerry
sketch	ketch
sketches	ketches
ski	ki
skid	kid
skidded	kidded
skidder	kidder
skidders	kidders
skidding	kidding
skiddy	kiddy
skids	kids
skier	kier
skiers	kiers
skill	kill
skilled	killed
skilling	killing
skillings	killings
skills	kills
skin	kin
skink	kink
skinked	kinked
skinking	kinking
skinks	kinks
skins	kins
skip	kip
skipped	kipped
skipper	kipper
skippered	kippered
skippering	kippering
skippers	kippers
skipping	kipping
skips	kips
skit	kit
skite	kite
skited	kited
skites	kites
skiting	kiting
skits	kits
skittle	kittle
skittles	kittles
slab	lab
slabs	labs
slack	lack
slacked	lacked
slacker	lacker
slackers	lackers
slacking	lacking
slacks	lacks
slag	lag
slagged	lagged
slagging	lagging
slags	lags
slain	lain
slake	lake
slaked	laked
slaker	laker
slakers	lakers
slakes	lakes
slaking	laking
slam	lam
slammed	lammed
slamming	lamming
slams	lams
slander	lander
slanders	landers
slang	lang
slanguage	language
slanguages	languages
slank	lank
slap	lap
slapped	lapped
slapper	lapper
slappers	lappers
slapping	lapping
slaps	laps
slash	lash
slashed	lashed
slasher	lasher
slashers	lashers
slashes	lashes
slashing	lashing
slashings	lashings
slat	lat
slatch	latch
slatches	latches
slate	late
slated	lated
slater	later
slather	lather
slathered	lathered
slathering	lathering
slathers	lathers
slats	lats
slaughter	laughter
slaughters	laughters
slave	lave
slaved	laved
slaver	laver
slavers	lavers
slaves	laves
slaving	laving
slavish	lavish
slavishly	lavishly
slavishness	lavishness
slavishnesses	lavishnesses
slaw	law
slaws	laws
slay	lay
slayed	layed
slayer	layer
slayers	layers
slaying	laying
slays	lays
sleave	leave
sleaved	leaved
sleaves	leaves
sleaving	leaving
sled	led
sledge	ledge
sledges	ledges
sleek	leek
sleeks	leeks
sleet	leet
sleets	leets
slender	lender
slept	lept
slice	lice
slick	lick
slicked	licked
slicker	licker
slickers	lickers
slicking	licking
slicks	licks
slid	lid
slier	lier
slight	light
slighted	lighted
slighter	lighter
slightest	lightest
slighting	lighting
slightly	lightly
slightness	lightness
slightnesses	lightnesses
slights	lights
slily	lily
slime	lime
slimed	limed
slimes	limes
slimier	limier
slimiest	limiest
sliminess	liminess
sliminesses	liminesses
sliming	liming
slimmer	limmer
slimmers	limmers
slimpsier	limpsier
slimpsiest	limpsiest
slimpsy	limpsy
slimy	limy
sling	ling
slinger	linger
slingers	lingers
slings	lings
slink	link
slinked	linked
slinking	linking
slinks	links
slinky	linky
slip	lip
slipless	lipless
slipped	lipped
slipper	lipper
slippered	lippered
slippers	lippers
slippier	lippier
slippiest	lippiest
slipping	lipping
slippy	lippy
slips	lips
slit	lit
slither	lither
slits	lits
slitter	litter
slitters	litters
sliver	liver
slivers	livers
slob	lob
slobber	lobber
slobbers	lobbers
slobby	lobby
slobs	lobs
slog	log
slogan	logan
slogans	logans
slogged	logged
slogger	logger
sloggers	loggers
slogging	logging
slogs	logs
sloid	loid
sloids	loids
sloop	loop
sloops	loops
slop	lop
slope	lope
sloped	loped
sloper	loper
slopers	lopers
slopes	lopes
sloping	loping
slopped	lopped
sloppier	loppier
sloppiest	loppiest
slopping	lopping
sloppy	loppy
slops	lops
slot	lot
sloth	loth
slots	lots
slotted	lotted
slotting	lotting
slough	lough
sloughs	loughs
slow	low
slowdown	lowdown
slowdowns	lowdowns
slowed	lowed
slower	lower
slowest	lowest
slowing	lowing
slowish	lowish
slowly	lowly
slowness	lowness
slownesses	lownesses
slows	lows
slubber	lubber
slubbers	lubbers
slues	lues
sluff	luff
sluffed	luffed
sluffing	luffing
sluffs	luffs
slug	lug
slugged	lugged
slugger	lugger
sluggers	luggers
slugging	lugging
slugs	lugs
slum	lum
slumber	lumber
slumbered	lumbered
slumberer	lumberer
slumberers	lumberers
slumbering	lumbering
slumbers	lumbers
slump	lump
slumped	lumped
slumping	lumping
slumps	lumps
slums	lums
slung	lung
slunk	lunk
slush	lush
slushed	lushed
slushes	lushes
slushing	lushing
smack	mack
smacks	macks
small	mall
smalls	malls
smalt	malt
smalts	malts
smart	mart
smarted	marted
smarten	marten
smartens	martens
smarting	marting
smarts	marts
smash	mash
smashed	mashed
smasher	masher
smashers	mashers
smashes	mashes
smashing	mashing
smatter	matter
smattered	mattered
smattering	mattering
smatters	matters
smaze	maze
smazes	mazes
smeek	meek
smell	mell
smelled	melled
smelling	melling
smells	mells
smelt	melt
smelted	melted
smelter	melter
smelters	melters
smelting	melting
smelts	melts
smerk	merk
smerks	merks
smew	mew
smews	mews
smidge	midge
smidges	midges
smile	mile
smiler	miler
smilers	milers
smiles	miles
smirk	mirk
smirker	mirker
smirkier	mirkier
smirkiest	mirkiest
smirks	mirks
smirky	mirky
smite	mite
smiter	miter
smiters	miters
smites	mites
smithers	mithers
smitten	mitten
smock	mock
smocked	mocked
smocking	mocking
smocks	mocks
smog	mog
smoggy	moggy
smogs	mogs
smoke	moke
smokes	mokes
smolder	molder
smoldered	moldered
smoldering	moldering
smolders	molders
smolt	molt
smolts	molts
smooch	mooch
smooched	mooched
smooches	mooches
smooching	mooching
smote	mote
smother	mother
smothered	mothered
smothering	mothering
smothers	mothers
smothery	mothery
smoulder	moulder
smouldered	mouldered
smouldering	mouldering
smoulders	moulders
smug	mug
smugger	mugger
smut	mut
smutch	mutch
smutches	mutches
smuts	muts
snag	nag
snagged	nagged
snaggier	naggier
snaggiest	naggiest
snagging	nagging
snaggy	naggy
snags	nags
snail	nail
snailed	nailed
snailing	nailing
snails	nails
snaked	naked
snap	nap
snapless	napless
snapped	napped
snapper	napper
snappers	nappers
snappier	nappier
snappiest	nappiest
snapping	napping
snappy	nappy
snaps	naps
snares	nares
snark	nark
snarks	narks
snarky	narky
snatch	natch
snaw	naw
sneap	neap
sneaps	neaps
sneck	neck
snecks	necks
snib	nib
snibbed	nibbed
snibbing	nibbing
snibs	nibs
snick	nick
snicked	nicked
snicker	nicker
snickered	nickered
snickering	nickering
snickers	nickers
snicking	nicking
snicks	nicks
snide	nide
sniffer	niffer
sniffers	niffers
sniggling	niggling
snip	nip
snipped	nipped
snipper	nipper
snippers	nippers
snippier	nippier
snippiest	nippiest
snippily	nippily
snipping	nipping
snippy	nippy
snips	nips
snit	nit
snits	nits
snob	nob
snobbier	nobbier
snobbiest	nobbiest
snobbily	nobbily
snobby	nobby
snobs	nobs
snog	nog
snogged	nogged
snogging	nogging
snogs	nogs
snook	nook
snooks	nooks
snot	not
snow	now
snows	nows
snub	nub
snubbier	nubbier
snubbiest	nubbiest
snubby	nubby
snubs	nubs
soak	oak
soaks	oaks
soar	oar
soared	oared
soaring	oaring
soars	oars
soaves	oaves
soca	oca
sod	od
soda	oda
sodas	odas
sodic	odic
sodium	odium
sodiums	odiums
sods	ods
soft	oft
soften	often
softener	oftener
softer	ofter
softest	oftest
soil	oil
soiled	oiled
soiling	oiling
soils	oils
soke	oke
sokes	okes
sold	old
solder	older
sole	ole
soles	oles
somber	omber
sombre	ombre
son	on
sone	one
sones	ones
sonly	only
sons	ons
soot	oot
soots	oots
sop	op
sops	ops
sora	ora
sorb	orb
sorbed	orbed
sorbing	orbing
sorbs	orbs
sordines	ordines
sore	ore
sores	ores
sort	ort
sorts	orts
sos	os
sought	ought
sour	our
sours	ours
souter	outer
souters	outers
sow	ow
sowed	owed
sowing	owing
sown	own
sox	ox
soy	oy
spa	pa
space	pace
spaced	paced
spacer	pacer
spacers	pacers
spaces	paces
spacier	pacier
spaciest	paciest
spacing	pacing
spacy	pacy
spail	pail
spails	pails
spale	pale
spales	pales
spall	pall
spalled	palled
spalling	palling
spalls	palls
spam	pam
span	pan
spang	pang
spanned	panned
spanning	panning
spans	pans
spar	par
sparable	parable
sparables	parables
spare	pare
spared	pared
sparer	parer
sparers	parers
spares	pares
sparge	parge
sparged	parged
sparges	parges
sparging	parging
sparing	paring
spark	park
sparked	parked
sparker	parker
sparkers	parkers
sparking	parking
sparks	parks
sparling	parling
sparred	parred
sparring	parring
sparry	parry
spars	pars
sparse	parse
sparser	parser
spartan	partan
spas	pas
spat	pat
spate	pate
spates	pates
spats	pats
spatted	patted
spatter	patter
spattered	pattered
spattering	pattering
spatters	patters
spatting	patting
spavin	pavin
spavins	pavins
spawn	pawn
spawned	pawned
spawner	pawner
spawners	pawners
spawning	pawning
spawns	pawns
spay	pay
spayed	payed
spaying	paying
spays	pays
speak	peak
speaking	peaking
speaks	peaks
spean	pean
speans	peans
spear	pear
spears	pears
spec	pec
speck	peck
specked	pecked
specking	pecking
specks	pecks
specs	pecs
spectate	pectate
spectates	pectates
speculate	peculate
speculated	peculated
speculates	peculates
speculating	peculating
speculation	peculation
speculations	peculations
speculator	peculator
speculators	peculators
sped	ped
speed	peed
speel	peel
speeled	peeled
speeling	peeling
speels	peels
speer	peer
speered	peered
speering	peering
speers	peers
speise	peise
speises	peises
spelt	pelt
spelter	pelter
spelters	pelters
spelts	pelts
spence	pence
spend	pend
spending	pending
spends	pends
spent	pent
sperm	perm
sperms	perms
spew	pew
spews	pews
spica	pica
spicas	picas
spice	pice
spied	pied
spier	pier
spiers	piers
spies	pies
spike	pike
spiked	piked
spiker	piker
spikers	pikers
spikes	pikes
spiking	piking
spile	pile
spiled	piled
spiles	piles
spiling	piling
spilings	pilings
spill	pill
spillage	pillage
spillages	pillages
spilled	pilled
spilling	pilling
spills	pills
spin	pin
spindling	pindling
spine	pine
spined	pined
spinelike	pinelike
spines	pines
spinier	pinier
spiniest	piniest
spinner	pinner
spinners	pinners
spinnies	pinnies
spinning	pinning
spinny	pinny
spins	pins
spinto	pinto
spintos	pintos
spiny	piny
spit	pit
spits	pits
spitted	pitted
spitter	pitter
spitters	pitters
spitting	pitting
splash	plash
splashed	plashed
splasher	plasher
splashers	plashers
splashes	plashes
splashier	plashier
splashiest	plashiest
splashing	plashing
splashy	plashy
splat	plat
splats	plats
splatted	platted
splatter	platter
splatters	platters
splatting	platting
splay	play
splayed	played
splaying	playing
splays	plays
spoke	poke
spoked	poked
spokes	pokes
spoking	poking
sponged	ponged
sponging	ponging
spontoon	pontoon
spontoons	pontoons
spoof	poof
spoofs	poofs
spoofy	poofy
spool	pool
spooled	pooled
spooling	pooling
spools	pools
spoon	poon
spoons	poons
spoor	poor
spore	pore
spored	pored
spores	pores
sporing	poring
sport	port
sported	ported
sporter	porter
sporters	porters
sporting	porting
sports	ports
spot	pot
spots	pots
spotted	potted
spotter	potter
spotters	potters
spottier	pottier
spottiest	pottiest
spotting	potting
spotty	potty
spout	pout
spouted	pouted
spouter	pouter
spouters	pouters
spouting	pouting
spouts	pouts
sprang	prang
sprangs	prangs
sprat	prat
sprats	prats
sprattle	prattle
sprattled	prattled
sprattles	prattles
sprattling	prattling
spray	pray
sprayed	prayed
sprayer	prayer
sprayers	prayers
spraying	praying
sprays	prays
spree	pree
sprees	prees
sprier	prier
spriest	priest
sprig	prig
sprigged	prigged
sprigging	prigging
sprigs	prigs
sprint	print
sprinted	printed
sprinter	printer
sprinters	printers
sprinting	printing
sprints	prints
spry	pry
spryer	pryer
spud	pud
spudding	pudding
spuds	puds
spun	pun
spunk	punk
spunkie	punkie
spunkier	punkier
spunkies	punkies
spunkiest	punkiest
spunkiness	punkiness
spunkinesses	punkinesses
spunks	punks
spunky	punky
spur	pur
spurge	purge
spurges	purges
spurred	purred
spurring	purring
spurs	purs
sputter	putter
sputtered	puttered
sputterer	putterer
sputterers	putterers
sputtering	puttering
sputters	putters
squad	quad
squadded	quadded
squadding	quadding
squads	quads
square	quare
squash	quash
squashed	quashed
squasher	quasher
squashers	quashers
squashes	quashes
squashing	quashing
squid	quid
squids	quids
squill	quill
squills	quills
squint	quint
squints	quints
squire	quire
squired	quired
squires	quires
squiring	quiring
squirt	quirt
squirted	quirted
squirting	quirting
squirts	quirts
stab	tab
stabbed	tabbed
stabbing	tabbing
stable	table
stabled	tabled
stablemate	tablemate
stablemates	tablemates
stables	tables
stabling	tabling
stabs	tabs
stack	tack
stacked	tacked
stacker	tacker
stackers	tackers
stacking	tacking
stacks	tacks
stag	tag
stagged	tagged
stagger	tagger
staggers	taggers
stagging	tagging
stags	tags
stain	tain
stains	tains
stake	take
stakeout	takeout
stakeouts	takeouts
stakes	takes
staking	taking
stale	tale
staler	taler
stales	tales
stalk	talk
stalked	talked
stalker	talker
stalkers	talkers
stalkier	talkier
stalkiest	talkiest
stalking	talking
stalks	talks
stalky	talky
stall	tall
stamp	tamp
stamped	tamped
stamper	tamper
stampers	tampers
stamping	tamping
stamps	tamps
stang	tang
stanged	tanged
stanging	tanging
stangs	tangs
stank	tank
stanks	tanks
stannic	tannic
stapes	tapes
star	tar
stare	tare
stared	tared
stares	tares
staring	taring
starred	tarred
starrier	tarrier
starriest	tarriest
starring	tarring
starry	tarry
stars	tars
start	tart
started	tarted
starter	tarter
starting	tarting
starts	tarts
stat	tat
state	tate
stater	tater
staters	taters
states	tates
stats	tats
staw	taw
steak	teak
steaks	teaks
steal	teal
steals	teals
steam	team
steamed	teamed
steaming	teaming
steams	teams
steed	teed
steel	teel
steels	teels
stela	tela
stelae	telae
stele	tele
steles	teles
stelic	telic
stench	tench
stenches	tenches
stent	tent
stents	tents
stern	tern
sterns	terns
stet	tet
stets	tets
stew	tew
stewed	tewed
stewing	tewing
stews	tews
stibial	tibial
stick	tick
sticked	ticked
sticker	ticker
stickers	tickers
sticking	ticking
stickle	tickle
stickled	tickled
stickler	tickler
sticklers	ticklers
stickles	tickles
stickling	tickling
sticks	ticks
stickseed	tickseed
stickseeds	tickseeds
stied	tied
sties	ties
stiff	tiff
stiffed	tiffed
stiffing	tiffing
stiffs	tiffs
stile	tile
stiles	tiles
still	till
stilled	tilled
stiller	tiller
stilling	tilling
stills	tills
stilt	tilt
stilted	tilted
stilting	tilting
stilts	tilts
stime	time
stimes	times
sting	ting
stinging	tinging
stings	tings
stinker	tinker
stinkers	tinkers
stint	tint
stinted	tinted
stinter	tinter
stinters	tinters
stinting	tinting
stints	tints
stipple	tipple
stippled	tippled
stippler	tippler
stipplers	tipplers
stipples	tipples
stippling	tippling
stoccata	toccata
stoccatas	toccatas
stoke	toke
stoked	toked
stoker	toker
stokers	tokers
stokes	tokes
stoking	toking
stole	tole
stoled	toled
stoles	toles
stone	tone
stoned	toned
stoner	toner
stoners	toners
stones	tones
stoney	toney
stonier	tonier
stoniest	toniest
stoning	toning
stonish	tonish
stony	tony
stook	took
stool	tool
stooled	tooled
stooling	tooling
stools	tools
stop	top
stope	tope
stoped	toped
stoper	toper
stopers	topers
stopes	topes
stoping	toping
stopped	topped
stopper	topper
stoppers	toppers
stopping	topping
stopple	topple
stoppled	toppled
stopples	topples
stoppling	toppling
stops	tops
store	tore
stores	tores
stories	tories
story	tory
stoss	toss
stot	tot
stots	tots
stour	tour
stours	tours
stout	tout
stouter	touter
stouts	touts
stow	tow
stowage	towage
stowages	towages
stowaway	towaway
stowaways	towaways
stowed	towed
stowing	towing
stows	tows
strain	train
strained	trained
strainer	trainer
strainers	trainers
straining	training
strains	trains
strait	trait
straits	traits
strap	trap
strapped	trapped
strapper	trapper
strappers	trappers
strapping	trapping
strappings	trappings
straps	traps
strass	trass
strasses	trasses
stray	tray
strays	trays
stress	tress
stressed	tressed
stresses	tresses
strews	trews
strick	trick
strickle	trickle
strickled	trickled
strickles	trickles
strickling	trickling
stricks	tricks
strident	trident
strike	trike
strikes	trikes
strip	trip
stripe	tripe
stripes	tripes
stripling	tripling
stripped	tripped
stripper	tripper
strippers	trippers
stripping	tripping
strips	trips
strode	trode
stroke	troke
stroked	troked
strokes	trokes
stroking	troking
stroll	troll
strolled	trolled
stroller	troller
strollers	trollers
strolling	trolling
strolls	trolls
strop	trop
strophic	trophic
strove	trove
strow	trow
strowed	trowed
strowing	trowing
strows	trows
stroy	troy
stroys	troys
struck	truck
strumpet	trumpet
strumpets	trumpets
stub	tub
stubbed	tubbed
stubbier	tubbier
stubbiest	tubbiest
stubbing	tubbing
stubby	tubby
stubs	tubs
stuck	tuck
stuff	tuff
stuffs	tuffs
stumble	tumble
stumbled	tumbled
stumbler	tumbler
stumblers	tumblers
stumbles	tumbles
stumbling	tumbling
stump	tump
stumped	tumped
stumping	tumping
stumps	tumps
stun	tun
stung	tung
stunned	tunned
stunning	tunning
stuns	tuns
stye	tye
styes	tyes
stying	tying
sugh	ugh
sughs	ughs
sullage	ullage
sullages	ullages
sulu	ulu
sulus	ulus
sum	um
sump	ump
sumps	umps
sun	un
sunbaked	unbaked
sunbathed	unbathed
sunbelt	unbelt
sunbelts	unbelts
sunblock	unblock
sunblocks	unblocks
sunbonnet	unbonnet
sunbonnets	unbonnets
sunburned	unburned
sunburnt	unburnt
sunchoke	unchoke
sunchokes	unchokes
sunder	under
sundress	undress
sundresses	undresses
sunless	unless
sunlike	unlike
sunlit	unlit
sunroof	unroof
sunroofs	unroofs
suns	uns
sunset	unset
sunsets	unsets
suntanned	untanned
sunwise	unwise
sup	up
supped	upped
supper	upper
suppers	uppers
supping	upping
sups	ups
surd	urd
surds	urds
surge	urge
surged	urged
surger	urger
surgers	urgers
surges	urges
surging	urging
swab	wab
swabs	wabs
swaddle	waddle
swaddled	waddled
swaddles	waddles
swaddling	waddling
swag	wag
swage	wage
swaged	waged
swager	wager
swagers	wagers
swages	wages
swagged	wagged
swagger	wagger
swaggers	waggers
swagging	wagging
swaging	waging
swags	wags
swail	wail
swails	wails
swain	wain
swains	wains
swale	wale
swales	wales
swallow	wallow
swallowed	wallowed
swallower	wallower
swallowers	wallowers
swallowing	wallowing
swallows	wallows
swampish	wampish
swan	wan
swank	wank
swanked	wanked
swanker	wanker
swanking	wanking
swanks	wanks
swanned	wanned
swanning	wanning
swans	wans
swap	wap
swapped	wapped
swapping	wapping
swaps	waps
sward	ward
swarded	warded
swarding	warding
swards	wards
sware	ware
swarm	warm
swarmed	warmed
swarmer	warmer
swarmers	warmers
swarming	warming
swarms	warms
swart	wart
swarty	warty
swash	wash
swashed	washed
swasher	washer
swashers	washers
swashes	washes
swashing	washing
swat	wat
swatch	watch
swatches	watches
swats	wats
swatter	watter
sway	way
sways	ways
swear	wear
swearer	wearer
swearers	wearers
swearing	wearing
swears	wears
sweenies	weenies
sweeny	weeny
sweep	weep
sweeper	weeper
sweepers	weepers
sweepier	weepier
sweepiest	weepiest
sweeping	weeping
sweepings	weepings
sweeps	weeps
sweepy	weepy
sweer	weer
sweet	weet
sweeting	weeting
sweets	weets
swell	well
swelled	welled
swellhead	wellhead
swellheads	wellheads
swelling	welling
swells	wells
swelter	welter
sweltered	weltered
sweltering	weltering
swelters	welters
swept	wept
swig	wig
swigged	wigged
swigging	wigging
swigs	wigs
swill	will
swilled	willed
swiller	willer
swillers	willers
swilling	willing
swills	wills
swindle	windle
swindled	windled
swindles	windles
swindling	windling
swine	wine
swing	wing
swinged	winged
swinger	winger
swingers	wingers
swingier	wingier
swingiest	wingiest
swinging	winging
swingman	wingman
swingmen	wingmen
swings	wings
swingy	wingy
swinish	winish
swink	wink
swinked	winked
swinking	winking
swinks	winks
swipe	wipe
swiped	wiped
swipes	wipes
swiping	wiping
swish	wish
swished	wished
swisher	wisher
swishers	wishers
swishes	wishes
swishing	wishing
swiss	wiss
swisses	wisses
switch	witch
switched	witched
switches	witches
switchgrass	witchgrass
switchgrasses	witchgrasses
switching	witching
swith	with
swithe	withe
swither	wither
swithered	withered
swithering	withering
swithers	withers
swive	wive
swived	wived
swives	wives
swiving	wiving
swoops	woops
swoosh	woosh
swooshed	wooshed
swooshes	wooshes
swooshing	wooshing
swop	wop
swops	wops
sword	word
swordplay	wordplay
swordplays	wordplays
swords	words
swore	wore
sworn	worn
swot	wot
swots	wots
swotted	wotted
swotting	wotting
swound	wound
swounded	wounded
swounding	wounding
swounds	wounds
tab	ab
table	able
tabled	abled
tables	ables
tabs	abs
tace	ace
taces	aces
tache	ache
taches	aches
tacnode	acnode
tacnodes	acnodes
taconite	aconite
taconites	aconites
tact	act
taction	action
tactions	actions
tacts	acts
tactual	actual
tactually	actually
tad	ad
tads	ads
tae	ae
tag	ag
tagger	agger
taggers	aggers
tail	ail
tailed	ailed
tailing	ailing
tails	ails
tain	ain
tains	ains
takin	akin
tala	ala
talar	alar
talas	alas
tale	ale
tales	ales
taliped	aliped
talipeds	alipeds
talkies	alkies
talky	alky
tall	all
tallied	allied
tallies	allies
tallow	allow
tallowed	allowed
tallowing	allowing
tallows	allows
tally	ally
tallying	allying
tam	am
tamis	amis
tamp	amp
tamps	amps
tan	an
tangle	angle
tangled	angled
tangler	angler
tanglers	anglers
tangles	angles
tangling	angling
tannates	annates
tantra	antra
tantrum	antrum
tantrums	antrums
tape	ape
taped	aped
tapelike	apelike
taper	aper
tapers	apers
tapes	apes
taping	aping
tar	ar
tare	are
tares	ares
tars	ars
tart	art
tarts	arts
tarty	arty
tas	as
task	ask
tasked	asked
tasking	asking
tasks	asks
tass	ass
tasses	asses
tasset	asset
tassets	assets
taster	aster
tasters	asters
tat	at
tate	ate
tates	ates
taught	aught
taunt	aunt
taunts	aunts
tautologous	autologous
taw	aw
tawed	awed
tawing	awing
tawny	awny
tax	ax
taxed	axed
taxes	axes
taxing	axing
taxis	axis
taxite	axite
taxites	axites
taxman	axman
taxmen	axmen
taxon	axon
taxons	axons
teach	each
tear	ear
teardrop	eardrop
teardrops	eardrops
teared	eared
tearful	earful
tearing	earing
tearless	earless
tears	ears
tease	ease
teased	eased
teasel	easel
teasels	easels
teases	eases
teasing	easing
teat	eat
teats	eats
teched	eched
ted	ed
teddies	eddies
teddy	eddy
teel	eel
teels	eels
teff	eff
teffs	effs
tegg	egg
teggs	eggs
tel	el
tell	ell
tells	ells
tels	els
ten	en
tenable	enable
tend	end
tended	ended
tender	ender
tenders	enders
tending	ending
tends	ends
tenfold	enfold
tenfolds	enfolds
tens	ens
tensile	ensile
tenter	enter
tentered	entered
tentering	entering
tenters	enters
tenure	enure
tenured	enured
tenures	enures
tepee	epee
tepees	epees
terbium	erbium
terbiums	erbiums
tern	ern
terne	erne
ternes	ernes
terns	erns
terror	error
terrorless	errorless
terrors	errors
testate	estate
testates	estates
tester	ester
testers	esters
tet	et
tetched	etched
teth	eth
tether	ether
tethers	ethers
teths	eths
thack	hack
thacked	hacked
thacking	hacking
thacks	hacks
thae	hae
thaler	haler
thalers	halers
thank	hank
thanked	hanked
thanker	hanker
thankers	hankers
thanking	hanking
thanks	hanks
tharm	harm
tharms	harms
that	hat
thatch	hatch
thatched	hatched
thatcher	hatcher
thatchers	hatchers
thatches	hatches
thatching	hatching
thaw	haw
thawed	hawed
thawing	hawing
thaws	haws
the	he
theater	heater
theaters	heaters
thebe	hebe
theft	heft
thefts	hefts
their	heir
theirs	heirs
theist	heist
theists	heists
them	hem
thematic	hematic
thematics	hematics
theme	heme
themes	hemes
then	hen
thence	hence
thenceforth	henceforth
thenceforward	henceforward
thens	hens
there	here
thereabout	hereabout
thereabouts	hereabouts
thereafter	hereafter
thereat	hereat
thereby	hereby
therein	herein
thereinafter	hereinafter
thereinto	hereinto
thereof	hereof
thereon	hereon
theres	heres
thereto	hereto
theretofore	heretofore
thereunder	hereunder
thereunto	hereunto
thereupon	hereupon
therewith	herewith
therm	herm
thermae	hermae
therms	herms
thew	hew
thews	hews
they	hey
thick	hick
thickish	hickish
thicks	hicks
thigh	high
thighs	highs
thill	hill
thills	hills
thin	hin
thins	hins
this	his
thither	hither
thitherto	hitherto
thitherward	hitherward
tho	ho
thole	hole
tholed	holed
tholes	holes
tholing	holing
thong	hong
thongs	hongs
thorn	horn
thorned	horned
thornier	hornier
thorniest	horniest
thornily	hornily
thorniness	horniness
thorninesses	horninesses
thorning	horning
thornless	hornless
thornlike	hornlike
thorns	horns
thorny	horny
those	hose
thug	hug
thugs	hugs
thump	hump
thumped	humped
thumping	humping
thumps	humps
thunk	hunk
thunks	hunks
thurl	hurl
thurls	hurls
tick	ick
ticker	icker
tickers	ickers
tides	ides
tiff	iff
till	ill
tiller	iller
tillite	illite
tillites	illites
tills	ills
timid	imid
tin	in
tingle	ingle
tingles	ingles
tinker	inker
tinkers	inkers
tinkle	inkle
tinkles	inkles
tinkling	inkling
tinklings	inklings
tinned	inned
tinner	inner
tinners	inners
tinning	inning
tins	ins
tinter	inter
tinters	inters
tirade	irade
tirades	irades
tire	ire
tired	ired
tireless	ireless
tires	ires
tiring	iring
tis	is
tissue	issue
tissued	issued
tissues	issues
tissuing	issuing
tit	it
titer	iter
tither	ither
tits	its
tivy	ivy
toast	oast
toasts	oasts
tocher	ocher
tochered	ochered
tochering	ochering
tochers	ochers
tod	od
tods	ods
toe	oe
toes	oes
toff	off
toffs	offs
toft	oft
toil	oil
toiled	oiled
toiler	oiler
toilers	oilers
toiling	oiling
toils	oils
tokay	okay
tokays	okays
toke	oke
tokes	okes
told	old
tole	ole
toles	oles
tom	om
tomenta	omenta
tomentum	omentum
toms	oms
ton	on
tone	one
tones	ones
tons	ons
tonus	onus
tonuses	onuses
toot	oot
toots	oots
top	op
tope	ope
toped	oped
topes	opes
toping	oping
tops	ops
tor	or
tora	ora
torc	orc
torcs	orcs
tore	ore
tores	ores
tors	ors
tort	ort
torts	orts
tother	other
totter	otter
totters	otters
touch	ouch
touched	ouched
touches	ouches
touching	ouching
tour	our
tours	ours
tout	out
touted	outed
touter	outer
touters	outers
touting	outing
touts	outs
tow	ow
towed	owed
towing	owing
town	own
towns	owns
toy	oy
toyer	oyer
toyers	oyers
trace	race
traced	raced
tracer	racer
tracers	racers
traces	races
tracing	racing
tracings	racings
track	rack
tracked	racked
tracker	racker
trackers	rackers
tracking	racking
tracks	racks
trad	rad
tragi	ragi
trail	rail
trailed	railed
trailer	railer
trailers	railers
trailhead	railhead
trailheads	railheads
trailing	railing
trails	rails
train	rain
trainband	rainband
trainbands	rainbands
trained	rained
training	raining
trains	rains
tram	ram
trammed	rammed
tramming	ramming
tramp	ramp
tramped	ramped
tramping	ramping
tramps	ramps
trams	rams
trance	rance
trances	rances
tranches	ranches
trank	rank
tranks	ranks
transom	ransom
transoms	ransoms
trap	rap
trapes	rapes
trapped	rapped
trapper	rapper
trappers	rappers
trapping	rapping
traps	raps
trapt	rapt
trash	rash
trashes	rashes
trave	rave
travel	ravel
traveled	raveled
traveler	raveler
travelers	ravelers
traveling	raveling
travelled	ravelled
traveller	raveller
travellers	ravellers
travelling	ravelling
travels	ravels
traves	raves
tray	ray
trays	rays
tread	read
treader	reader
treaders	readers
treading	reading
treads	reads
treason	reason
treasonable	reasonable
treasonably	reasonably
treasons	reasons
treddle	reddle
treddled	reddled
treddles	reddles
treddling	reddling
tree	ree
treed	reed
trees	rees
tref	ref
trenail	renail
trenails	renails
trend	rend
trended	rended
trending	rending
trends	rends
tret	ret
trets	rets
trevet	revet
trevets	revets
trial	rial
trials	rials
tribes	ribes
trice	rice
triced	riced
trices	rices
tricing	ricing
trick	rick
tricked	ricked
tricking	ricking
tricks	ricks
trident	rident
trifle	rifle
trifled	rifled
trifler	rifler
triflers	riflers
trifles	rifles
trifling	rifling
triflings	riflings
trig	rig
trigged	rigged
trigger	rigger
triggers	riggers
trigging	rigging
trigs	rigs
trill	rill
trilled	rilled
trilling	rilling
trills	rills
trim	rim
trimer	rimer
trimers	rimers
trimester	rimester
trimesters	rimesters
trimmed	rimmed
trimmer	rimmer
trimmers	rimmers
trimming	rimming
trims	rims
trip	rip
tripe	ripe
tripes	ripes
tripped	ripped
tripper	ripper
trippers	rippers
tripping	ripping
trips	rips
trite	rite
trivet	rivet
trivets	rivets
trock	rock
trocked	rocked
trocking	rocking
trocks	rocks
trod	rod
trode	rode
troll	roll
trolled	rolled
troller	roller
trollers	rollers
trolling	rolling
trollings	rollings
trolls	rolls
tromp	romp
tromped	romped
tromping	romping
tromps	romps
trope	rope
tropes	ropes
trot	rot
trots	rots
trotted	rotted
trotter	rotter
trotters	rotters
trotting	rotting
trouble	rouble
troubles	roubles
trough	rough
troughs	roughs
trouped	rouped
trouping	rouping
trouser	rouser
trousers	rousers
trousseau	rousseau
trousseaus	rousseaus
trout	rout
trouts	routs
trove	rove
trover	rover
trovers	rovers
troves	roves
trow	row
trowed	rowed
trowel	rowel
troweled	roweled
troweling	roweling
trowelled	rowelled
trowelling	rowelling
trowels	rowels
trowing	rowing
trows	rows
trowth	rowth
trowths	rowths
truck	ruck
trucked	rucked
trucking	rucking
truckle	ruckle
truckled	ruckled
truckles	ruckles
truckling	ruckling
trucks	rucks
true	rue
trued	rued
truer	ruer
trues	rues
truffe	ruffe
truffes	ruffes
truffle	ruffle
truffled	ruffled
truffles	ruffles
trug	rug
trugs	rugs
truing	ruing
truly	ruly
trump	rump
trumps	rumps
trundle	rundle
trundles	rundles
trunnel	runnel
trunnels	runnels
trust	rust
trustable	rustable
trusted	rusted
trustier	rustier
trustiest	rustiest
trustily	rustily
trustiness	rustiness
trustinesses	rustinesses
trusting	rusting
trustless	rustless
trusts	rusts
trusty	rusty
truth	ruth
truthful	ruthful
truthfully	ruthfully
truthfulness	ruthfulness
truthfulnesses	ruthfulnesses
truths	ruths
tsade	sade
tsades	sades
tsadi	sadi
tsadis	sadis
tsores	sores
tsuba	suba
tumbles	umbles
tump	ump
tumped	umped
tumping	umping
tumps	umps
tun	un
tunable	unable
tuns	uns
tup	up
tupped	upped
tupping	upping
tups	ups
turban	urban
turd	urd
turds	urds
turgencies	urgencies
turgency	urgency
turgent	urgent
turn	urn
turns	urns
tut	ut
tuts	uts
twaddle	waddle
twaddled	waddled
twaddler	waddler
twaddlers	waddlers
twaddles	waddles
twaddling	waddling
twae	wae
twaes	waes
twain	wain
twains	wains
twangle	wangle
twangled	wangled
twangler	wangler
twanglers	wanglers
twangles	wangles
twangling	wangling
twas	was
twat	wat
twats	wats
twattle	wattle
twattled	wattled
twattles	wattles
twattling	wattling
tweak	weak
twee	wee
tweed	weed
tweedier	weedier
tweediest	weediest
tweediness	weediness
tweedinesses	weedinesses
tweeds	weeds
tweedy	weedy
tween	ween
tweenies	weenies
tweeny	weeny
tweet	weet
tweeted	weeted
tweeting	weeting
tweets	weets
twiddle	widdle
twiddled	widdled
twiddles	widdles
twiddling	widdling
twig	wig
twigged	wigged
twiggier	wiggier
twiggiest	wiggiest
twigging	wigging
twiggy	wiggy
twigless	wigless
twiglike	wiglike
twigs	wigs
twill	will
twilled	willed
twilling	willing
twills	wills
twin	win
twine	wine
twined	wined
twines	wines
twinged	winged
twinging	winging
twinier	winier
twiniest	winiest
twining	wining
twinkle	winkle
twinkled	winkled
twinkles	winkles
twinkling	winkling
twinned	winned
twinning	winning
twinnings	winnings
twins	wins
twiny	winy
twist	wist
twisted	wisted
twisting	wisting
twists	wists
twit	wit
twitch	witch
twitched	witched
twitches	witches
twitchier	witchier
twitchiest	witchiest
twitching	witching
twitchy	witchy
twits	wits
twitted	witted
twitting	witting
two	wo
twos	wos
tye	ye
tyes	yes
tyin	yin
tzaddik	zaddik
tzaddikim	zaddikim
udo	do
udon	don
udons	dons
udos	dos
ulama	lama
ulamas	lamas
umm	mm
unary	nary
uneaten	neaten
unit	nit
unite	nite
uniter	niter
uniters	niters
unites	nites
units	nits
upas	pas
upases	pases
upend	pend
upended	pended
upending	pending
upends	pends
uplight	plight
uplighted	plighted
uplighting	plighting
uplights	plights
uplink	plink
uplinks	plinks
upraise	praise
upraised	praised
upraiser	praiser
upraisers	praisers
upraises	praises
upraising	praising
uprate	prate
uprated	prated
uprates	prates
uprating	prating
upreach	preach
upreached	preached
upreaches	preaches
upreaching	preaching
uprise	prise
uprises	prises
uprising	prising
uprose	prose
urare	rare
urares	rares
urase	rase
urases	rases
urate	rate
urates	rates
ureal	real
uredia	redia
uredial	redial
uredo	redo
uredos	redos
urial	rial
urials	rials
uruses	ruses
usable	sable
usage	sage
usages	sages
user	ser
users	sers
using	sing
usurer	surer
uta	ta
utas	tas
utile	tile
uveal	veal
vacuities	acuities
vacuity	acuity
vagile	agile
vagilities	agilities
vagility	agility
vague	ague
vail	ail
vailed	ailed
vailing	ailing
vails	ails
vain	ain
vair	air
vairs	airs
vale	ale
vales	ales
valgoid	algoid
valine	aline
valines	alines
valley	alley
valleys	alleys
vamp	amp
vamps	amps
van	an
vane	ane
vanes	anes
var	ar
varia	aria
vars	ars
vas	as
vaster	aster
vat	at
vaunt	aunt
vauntie	auntie
vaunts	aunts
vaunty	aunty
vaw	aw
vaward	award
vawards	awards
veery	eery
velate	elate
veld	eld
velds	elds
velites	elites
venatic	enatic
venation	enation
venations	enations
vend	end
vended	ended
vender	ender
venders	enders
vending	ending
vends	ends
vendue	endue
vendues	endues
ventail	entail
ventails	entails
venter	enter
venters	enters
vera	era
veristic	eristic
verses	erses
verst	erst
vestral	estral
vet	et
vetch	etch
vetches	etches
vex	ex
vexes	exes
vexing	exing
vice	ice
viced	iced
viceless	iceless
vices	ices
vicing	icing
vid	id
videographies	ideographies
videography	ideography
vids	ids
vill	ill
vills	ills
vindicate	indicate
vindicated	indicated
vindicates	indicates
vindicating	indicating
vindication	indication
vindications	indications
vindicative	indicative
vindicator	indicator
vindicators	indicators
vindicatory	indicatory
vires	ires
virid	irid
viridescent	iridescent
vis	is
voe	oe
voes	oes
vole	ole
voles	oles
vomer	omer
vomers	omers
vomit	omit
vomits	omits
von	on
vouch	ouch
vouched	ouched
vouches	ouches
vouching	ouching
vow	ow
vowed	owed
vowing	owing
vox	ox
vroom	room
vroomed	roomed
vrooming	rooming
vrooms	rooms
vrow	row
vrows	rows
vugh	ugh
vughs	ughs
vulva	ulva
vulvas	ulvas
wab	ab
wabs	abs
wad	ad
wadded	added
wadder	adder
wadders	adders
wadding	adding
waddle	addle
waddled	addled
waddles	addles
waddling	addling
wads	ads
wae	ae
waff	aff
waft	aft
wafter	after
wafters	afters
wag	ag
wage	age
waged	aged
wageless	ageless
wager	ager
wagers	agers
wages	ages
wagger	agger
waggers	aggers
waging	aging
wagon	agon
wagons	agons
wail	ail
wailed	ailed
wailing	ailing
wails	ails
wain	ain
wains	ains
wair	air
waired	aired
wairing	airing
wairs	airs
wait	ait
waits	aits
waiver	aiver
waivers	aivers
wale	ale
wales	ales
wall	all
wallies	allies
wallow	allow
wallowed	allowed
wallowing	allowing
wallows	allows
walls	alls
wally	ally
wamble	amble
wambled	ambled
wambles	ambles
wambling	ambling
wamus	amus
wamuses	amuses
wan	an
wand	and
wands	ands
wane	ane
wanes	anes
wangle	angle
wangled	angled
wangler	angler
wanglers	anglers
wangles	angles
wangling	angling
wanion	anion
wanions	anions
want	ant
wanted	anted
wanting	anting
wants	ants
wany	any
war	ar
ware	are
wares	ares
wark	ark
warks	arks
warm	arm
warmed	armed
warmer	armer
warmers	armers
warming	arming
warms	arms
warrant	arrant
wars	ars
wart	art
wartier	artier
wartiest	artiest
wartless	artless
warts	arts
warty	arty
was	as
wash	ash
washed	ashed
washes	ashes
washier	ashier
washiest	ashiest
washing	ashing
washy	ashy
wasp	asp
waspish	aspish
wasps	asps
wassail	assail
wassailed	assailed
wassailer	assailer
wassailers	assailers
wassailing	assailing
wassails	assails
waster	aster
wasters	asters
wat	at
watap	atap
wataps	ataps
watt	att
wattest	attest
waught	aught
waughts	aughts
wauk	auk
wauks	auks
wave	ave
waver	aver
wavers	avers
waves	aves
waw	aw
wawl	awl
wawls	awls
wax	ax
waxed	axed
waxes	axes
waxing	axing
waxlike	axlike
way	ay
ways	ays
weanling	eanling
weanlings	eanlings
wear	ear
wearing	earing
wears	ears
weasel	easel
weasels	easels
weave	eave
weaved	eaved
weaves	eaves
webbed	ebbed
webbing	ebbing
wecht	echt
wed	ed
wedge	edge
wedged	edged
wedges	edges
wedgier	edgier
wedgiest	edgiest
wedging	edging
wedgy	edgy
week	eek
weel	eel
weft	eft
wefts	efts
weight	eight
weights	eights
weighty	eighty
weld	eld
welder	elder
welders	elders
welds	elds
well	ell
wells	ells
wen	en
wend	end
wended	ended
wending	ending
wends	ends
wens	ens
were	ere
wester	ester
westers	esters
wet	et
wether	ether
wethers	ethers
wha	ha
whack	hack
whacked	hacked
whacker	hacker
whackers	hackers
whacking	hacking
whacks	hacks
whale	hale
whaled	haled
whaler	haler
whalers	halers
whales	hales
whaling	haling
wham	ham
whammed	hammed
whamming	hamming
whammy	hammy
whams	hams
whang	hang
whanged	hanged
whanging	hanging
whangs	hangs
whap	hap
whapped	happed
whapping	happing
whaps	haps
what	hat
whats	hats
wheal	heal
wheals	heals
wheat	heat
wheats	heats
wheel	heel
wheeled	heeled
wheeler	heeler
wheelers	heelers
wheeling	heeling
wheelings	heelings
wheelless	heelless
wheels	heels
wheeze	heeze
wheezed	heezed
wheezes	heezes
wheezing	heezing
whelm	helm
whelmed	helmed
whelming	helming
whelms	helms
whelp	help
whelped	helped
whelping	helping
whelps	helps
when	hen
whence	hence
whens	hens
where	here
whereabout	hereabout
whereabouts	hereabouts
whereat	hereat
whereby	hereby
wherein	herein
whereinto	hereinto
whereof	hereof
whereon	hereon
wheres	heres
whereto	hereto
whereunto	hereunto
whereupon	hereupon
wherewith	herewith
wherried	herried
wherries	herries
wherry	herry
wherrying	herrying
whet	het
whets	hets
whew	hew
whews	hews
whey	hey
whid	hid
whim	him
whin	hin
whinge	hinge
whinged	hinged
whinges	hinges
whinging	hinging
whinnied	hinnied
whinnies	hinnies
whinny	hinny
whinnying	hinnying
whins	hins
whip	hip
whiplike	hiplike
whipped	hipped
whipper	hipper
whippier	hippier
whippiest	hippiest
whipping	hipping
whippy	hippy
whips	hips
whist	hist
whisted	histed
whisting	histing
whists	hists
whit	hit
whither	hither
whitherward	hitherward
whits	hits
whitter	hitter
whitters	hitters
who	ho
whole	hole
wholes	holes
wholism	holism
wholisms	holisms
wholistic	holistic
wholly	holly
whoof	hoof
whoofed	hoofed
whoofing	hoofing
whoofs	hoofs
whoop	hoop
whooped	hooped
whooper	hooper
whoopers	hoopers
whooping	hooping
whoopla	hoopla
whooplas	hooplas
whoops	hoops
whop	hop
whopped	hopped
whopper	hopper
whoppers	hoppers
whopping	hopping
whops	hops
whose	hose
whump	hump
whumped	humped
whumping	humping
whumps	humps
whup	hup
wich	ich
wick	ick
wicker	icker
wickers	ickers
wides	ides
wigged	igged
wigging	igging
will	ill
willer	iller
wills	ills
willy	illy
wimp	imp
wimpish	impish
wimpishness	impishness
wimpishnesses	impishnesses
wimps	imps
win	in
winch	inch
winched	inched
winches	inches
winching	inching
windigo	indigo
windigos	indigos
window	indow
windowed	indowed
windowing	indowing
windows	indows
wink	ink
winked	inked
winker	inker
winkers	inkers
winking	inking
winkle	inkle
winkles	inkles
winkling	inkling
winks	inks
winned	inned
winner	inner
winners	inners
winning	inning
winnings	innings
wins	ins
winter	inter
winters	inters
wire	ire
wired	ired
wireless	ireless
wires	ires
wiring	iring
wis	is
wit	it
witch	itch
witched	itched
witches	itches
witchier	itchier
witchiest	itchiest
witching	itching
witchings	itchings
witchy	itchy
wither	ither
wits	its
woe	oe
woes	oes
woke	oke
wold	old
wolds	olds
women	omen
won	on
wons	ons
woops	oops
woorali	oorali
wooralis	ooralis
woozier	oozier
wooziest	ooziest
woozily	oozily
wooziness	ooziness
woozinesses	oozinesses
woozy	oozy
wop	op
wops	ops
wore	ore
wormer	ormer
wormers	ormers
wort	ort
worts	orts
wos	os
woven	oven
wovens	ovens
wow	ow
wowed	owed
wowing	owing
wrack	rack
wracked	racked
wrackful	rackful
wracking	racking
wracks	racks
wrang	rang
wrap	rap
wrapped	rapped
wrapper	rapper
wrappers	rappers
wrapping	rapping
wraps	raps
wrapt	rapt
wrassle	rassle
wrassled	rassled
wrassles	rassles
wrassling	rassling
wrath	rath
wreck	reck
wrecked	recked
wrecking	recking
wrecks	recks
wrest	rest
wrested	rested
wrester	rester
wresters	resters
wresting	resting
wrests	rests
wretch	retch
wretched	retched
wretches	retches
wrick	rick
wricked	ricked
wricking	ricking
wricks	ricks
wright	right
wrights	rights
wring	ring
wringed	ringed
wringer	ringer
wringers	ringers
wringing	ringing
wrings	rings
write	rite
writes	rites
wrote	rote
wrung	rung
wye	ye
wyes	yes
xeroses	eroses
xerotic	erotic
xis	is
xylem	ylem
xylems	ylems
yaff	aff
yag	ag
yager	ager
yagers	agers
yah	ah
yam	am
yamen	amen
yamens	amens
yantra	antra
yar	ar
yare	are
yarrow	arrow
yarrows	arrows
yataghan	ataghan
yataghans	ataghans
yauld	auld
yaw	aw
yawed	awed
yawing	awing
yawl	awl
yawls	awls
yawn	awn
yawned	awned
yawning	awning
yawns	awns
yay	ay
yays	ays
ycleped	cleped
yclept	clept
yeanling	eanling
yeanlings	eanlings
year	ear
yearly	early
yearn	earn
yearned	earned
yearner	earner
yearners	earners
yearning	earning
yearnings	earnings
yearns	earns
years	ears
yeast	east
yeasting	easting
yeasts	easts
yegg	egg
yeggs	eggs
yeh	eh
yeld	eld
yelk	elk
yelks	elks
yell	ell
yells	ells
yen	en
yens	ens
yes	es
yeses	eses
yesses	esses
yester	ester
yet	et
yid	id
yids	ids
yill	ill
yills	ills
yin	in
yins	ins
yod	od
yods	ods
yogee	ogee
yogees	ogees
yoke	oke
yokes	okes
yom	om
yon	on
yore	ore
yores	ores
your	our
yours	ours
yourself	ourself
yourselves	ourselves
yow	ow
yowe	owe
yowed	owed
yowes	owes
yowing	owing
yowl	owl
yowls	owls
yulan	ulan
yulans	ulans
yum	um
yup	up
yupon	upon
yups	ups
ywis	wis
zag	ag
zamia	amia
zamias	amias
zany	any
zarf	arf
zarfs	arfs
zas	as
zax	ax
zaxes	axes
zayin	ayin
zayins	ayins
zed	ed
zen	en
zeros	eros
zester	ester
zesters	esters
zeta	eta
zetas	etas
zigged	igged
zigging	igging
zill	ill
zills	ills
zin	in
zincite	incite
zincites	incites
zinky	inky
zins	ins
zit	it
zither	ither
zits	its
zone	one
zones	ones
zonetime	onetime
zoologic	oologic
zoologies	oologies
zoologist	oologist
zoologists	oologists
zoology	oology
zoophyte	oophyte
zoophytes	oophytes
zoosperm	oosperm
zoosperms	oosperms
zoospore	oospore
zoospores	oospores
zoosporic	oosporic
